ID,Year_Birth,Age,Education,Marital_Status,Income,Recency,MntWines,MntFruits,MntMeatProducts,MntFishProducts,MntSweetProducts,MntGoldProds,Total Amount,NumDealsPurchases,NumWebPurchases,NumCatalogPurchases,NumStorePurchases,purchases item count
5524,1957,67,Graduation,Single,58138,58,635,88,546,172,88,88,1617,3,8,10,4,25
2174,1954,70,Graduation,Single,46344,38,11,1,6,2,1,6,27,2,1,1,2,6
4141,1965,59,Graduation,Together,71613,26,426,49,127,111,21,42,776,1,8,2,10,21
6182,1984,40,Graduation,Together,26646,26,11,4,20,10,3,5,53,2,2,0,4,8
5324,1981,43,PhD,Married,58293,94,173,43,118,46,27,15,422,5,5,3,6,19
7446,1967,57,Master,Together,62513,16,520,42,98,0,42,14,716,2,6,4,10,22
965,1971,53,Graduation,Divorced,55635,34,235,65,164,50,49,27,590,4,7,3,7,21
6177,1985,39,PhD,Married,33454,32,76,10,56,3,1,23,169,2,4,0,4,10
4855,1974,50,PhD,Together,30351,19,14,0,24,3,3,2,46,1,3,0,2,6
5899,1950,74,PhD,Together,5648,68,28,0,6,1,1,13,49,1,1,0,0,2
1994,1983,41,Graduation,Married,,11,5,5,6,0,2,1,19,1,1,0,2,4
387,1976,48,Basic,Married,7500,59,6,16,11,11,1,16,61,1,2,0,3,6
2125,1959,65,Graduation,Divorced,63033,82,194,61,480,225,112,30,1102,1,3,4,8,16
8180,1952,72,Master,Divorced,59354,53,233,2,53,3,5,14,310,3,6,1,5,15
2569,1987,37,Graduation,Married,17323,38,3,14,17,6,1,5,46,1,1,0,3,5
2114,1946,78,PhD,Single,82800,23,1006,22,115,59,68,45,1315,1,7,6,12,26
9736,1980,44,Graduation,Married,41850,51,53,5,19,2,13,4,96,3,3,0,3,9
4939,1946,78,Graduation,Together,37760,20,84,5,38,150,12,28,317,2,4,1,6,13
6565,1949,75,Master,Married,76995,91,1012,80,498,0,16,176,1782,2,11,4,9,26
2278,1985,39,2n Cycle,Single,33812,86,4,17,19,30,24,39,133,2,2,1,3,8
9360,1982,42,Graduation,Married,37040,41,86,2,73,69,38,48,316,1,4,2,5,12
5376,1979,45,Graduation,Married,2447,42,1,1,1725,1,1,1,1730,15,0,28,0,43
1993,1949,75,PhD,Married,58607,63,867,0,86,0,0,19,972,3,2,3,9,17
4047,1954,70,PhD,Married,65324,0,384,0,102,21,32,5,544,3,6,2,9,20
1409,1951,73,Graduation,Together,40689,69,270,3,27,39,6,99,444,7,7,1,5,20
7892,1969,55,Graduation,Single,18589,89,6,4,25,15,12,13,75,2,2,1,3,8
2404,1976,48,Graduation,Married,53359,4,173,4,30,3,6,41,257,4,5,1,4,14
5255,1986,38,Graduation,Single,,19,5,1,3,3,263,362,637,0,27,0,0,27
9422,1989,35,Graduation,Married,38360,26,36,2,42,20,21,10,131,2,2,1,4,9
1966,1965,59,PhD,Married,84618,96,684,100,801,21,66,0,1672,1,6,9,10,26
6864,1989,35,Master,Divorced,10979,34,8,4,10,2,2,4,30,2,3,0,3,8
3033,1963,61,Master,Together,38620,56,112,17,44,34,22,89,318,1,2,5,3,11
5710,1970,54,Graduation,Together,40548,31,110,0,5,2,0,3,120,2,2,1,4,9
7373,1952,72,PhD,Divorced,46610,8,96,12,96,33,22,43,302,6,4,1,6,17
8755,1946,78,Master,Married,68657,4,482,34,471,119,68,22,1196,1,3,5,9,18
10738,1951,73,Master,Single,49389,55,40,0,19,2,1,3,65,1,2,0,3,6
4339,1970,54,PhD,Married,67353,37,702,17,151,0,8,35,913,5,5,6,12,28
10755,1976,48,2n Cycle,Married,23718,76,6,3,14,15,7,36,81,3,3,1,2,9
8595,1973,51,Graduation,Widow,42429,99,55,0,6,2,0,4,67,2,1,1,3,7
2968,1943,81,PhD,Divorced,48948,53,437,8,206,160,49,42,902,2,7,10,5,24
8601,1980,44,Graduation,Married,80011,3,421,76,536,82,178,102,1395,2,8,6,5,21
503,1985,39,Master,Married,20559,88,13,1,29,3,0,7,53,2,2,0,3,7
8430,1957,67,Graduation,Together,21994,4,9,0,6,3,1,3,22,1,0,0,3,4
7281,1959,65,PhD,Single,,80,81,11,50,3,2,39,186,1,1,3,4,9
2139,1975,49,Master,Married,7500,19,3,1,10,3,2,12,31,3,2,0,3,8
1371,1976,48,Graduation,Single,79941,72,123,164,266,227,30,174,984,1,2,4,9,16
9909,1996,28,2n Cycle,Married,7500,24,3,18,14,15,22,50,122,3,3,1,3,10
7286,1968,56,Graduation,Together,41728,92,13,6,15,3,5,13,55,1,2,0,2,5
7244,1951,73,Graduation,Single,,96,48,5,48,6,10,7,124,3,2,1,4,10
6566,1954,70,PhD,Married,72550,39,826,50,317,50,38,38,1319,9,5,2,12,28
8614,1957,67,Graduation,Widow,65486,29,245,19,125,37,67,14,507,1,4,2,10,17
4114,1964,60,Master,Married,79143,2,650,37,780,27,167,32,1693,1,6,9,13,29
1331,1977,47,Graduation,Single,35790,54,12,6,20,30,1,3,72,2,2,0,3,7
2225,1977,47,Graduation,Divorced,82582,54,510,120,550,156,40,241,1617,1,4,9,7,21
9381,1978,46,Graduation,Married,66373,57,328,9,124,12,24,109,606,7,4,2,10,23
6260,1955,69,Master,Together,82384,55,984,51,432,180,120,190,1957,1,3,10,13,27
10383,1966,58,Graduation,Divorced,70287,30,295,35,482,121,120,40,1093,1,5,5,10,21
7437,1988,36,Graduation,Single,27938,31,13,0,8,2,1,5,29,1,1,0,4,6
8557,1982,42,Graduation,Single,,57,11,3,22,2,2,6,46,2,2,0,3,7
8375,1968,56,PhD,Married,55954,63,447,0,28,0,0,43,518,3,8,2,6,19
6853,1982,42,Master,Single,75777,12,712,26,538,69,13,80,1438,1,3,6,11,21
3076,1975,49,Graduation,Together,66653,18,452,18,102,16,18,6,612,4,4,2,12,22
1012,1952,72,Graduation,Single,61823,26,523,7,134,37,14,169,884,4,8,2,10,24
6518,1951,73,PhD,Widow,67680,8,546,0,48,0,6,6,606,1,7,3,8,19
4137,1948,76,Graduation,Together,70666,29,398,40,367,119,122,30,1076,1,7,4,4,16
8082,1971,53,Graduation,Married,25721,75,1,3,6,3,6,15,34,1,1,1,2,5
1386,1967,57,Graduation,Together,32474,0,10,0,1,0,0,0,11,1,1,0,2,4
9369,1979,45,2n Cycle,Single,88194,19,688,14,309,201,24,38,1274,1,11,10,10,32
4477,1958,66,Graduation,Together,69096,4,247,49,159,7,82,109,653,1,5,2,10,18
1357,1970,54,Graduation,Together,74854,90,856,59,487,58,29,73,1562,7,2,5,5,19
1402,1954,70,Master,Married,66991,1,496,36,460,189,60,12,1253,3,4,8,6,21
10629,1973,51,2n Cycle,Married,,25,25,3,43,17,4,17,109,3,3,0,3,9
6312,1959,65,Graduation,Married,65031,29,258,107,291,84,37,86,863,4,10,3,13,30
8132,1975,49,PhD,Married,60631,88,565,6,65,0,6,19,661,5,9,2,8,24
1050,1952,72,Graduation,Married,28332,58,14,10,13,4,15,9,65,1,2,1,4,8
5846,1977,47,Graduation,Divorced,40246,68,2,1,6,2,1,1,13,1,1,0,2,4
1859,1972,52,Master,Married,75251,34,721,111,925,97,18,18,1890,1,7,6,5,19
7503,1976,48,Graduation,Single,75825,40,1032,105,779,137,105,51,2209,0,5,8,9,22
10401,1976,48,2n Cycle,Together,26326,12,1,0,5,0,3,9,18,1,0,0,3,4
1618,1965,59,Graduation,Together,56046,9,577,0,64,0,0,51,692,2,10,1,8,21
3332,1985,39,Graduation,Single,29760,87,64,4,68,7,5,17,165,4,3,1,4,12
2261,1969,55,Graduation,Married,26304,5,4,1,5,2,0,4,16,1,1,0,2,4
5346,1973,51,2n Cycle,Married,23559,87,25,5,19,7,0,23,79,3,3,0,3,9
4119,1963,61,Master,Together,38620,56,112,17,44,34,22,89,318,1,2,5,3,11
535,1987,37,Graduation,Divorced,81361,18,163,23,424,27,65,76,778,1,3,10,13,27
5268,1960,64,Graduation,Married,29440,95,17,8,14,10,4,3,56,2,1,0,4,7
273,1970,54,Master,Married,36138,48,130,0,16,0,0,5,151,5,3,1,4,13
4452,1957,67,Graduation,Single,50388,3,292,6,37,0,3,34,372,4,6,1,6,17
8504,1973,51,Graduation,Married,79593,70,350,60,568,110,133,145,1366,1,5,6,7,19
771,1967,57,Graduation,Together,54178,79,135,9,39,4,0,7,194,1,2,2,5,10
8996,1957,67,PhD,Married,,4,230,42,192,49,37,53,603,12,7,2,8,29
9235,1957,67,Graduation,Single,,45,7,0,8,2,0,1,18,1,1,0,2,4
5798,1973,51,Master,Together,,87,445,37,359,98,28,18,985,1,2,4,8,15
11178,1972,52,Master,Single,42394,69,15,2,10,0,1,4,32,1,1,0,3,5
2230,1970,54,PhD,Married,23626,84,27,2,14,0,0,0,43,3,3,1,3,10
7516,1983,41,Graduation,Married,30096,30,5,3,11,12,5,9,45,1,2,0,3,6
7247,1960,64,Graduation,Widow,47916,72,505,0,26,0,0,75,606,5,7,4,6,22
11100,1972,52,Graduation,Divorced,51813,37,51,2,7,0,1,2,63,2,2,0,3,7
4646,1951,73,2n Cycle,Married,78497,44,207,26,447,75,0,223,978,1,5,7,12,25
3037,1983,41,PhD,Married,50150,32,135,46,92,65,61,11,410,2,5,2,7,16
1473,1960,64,2n Cycle,Single,47823,0,53,1,5,2,1,10,72,2,2,0,3,7
1016,1959,65,PhD,Single,34554,43,41,1,6,2,0,5,55,2,2,0,3,7
4518,1979,45,Graduation,Together,85693,59,386,172,183,185,132,111,1169,2,9,5,11,27
9370,1945,79,PhD,Married,65846,68,562,81,276,80,40,81,1120,1,6,3,6,16
8908,1959,65,Graduation,Married,87195,35,217,76,690,50,26,38,1097,1,3,11,5,20
8373,1979,45,Basic,Together,24594,94,1,3,6,10,0,9,29,1,1,0,3,5
7533,1964,60,Graduation,Married,49096,15,144,1,32,2,1,7,187,4,4,1,4,13
2683,1969,55,Graduation,Married,52413,56,295,106,271,75,98,65,910,4,6,4,12,26
3629,1978,46,Graduation,Single,38557,17,76,3,31,4,4,27,145,2,3,1,3,9
10991,1960,64,Master,Married,89058,18,454,194,106,31,22,43,850,1,5,4,4,14
5077,1979,45,Graduation,Together,77298,46,425,115,292,23,35,79,969,1,6,6,11,24
7431,1991,33,PhD,Single,68126,40,1332,17,311,23,51,86,1820,1,7,4,5,17
3267,1963,61,Master,Together,57288,27,527,0,21,0,0,60,608,3,8,1,8,20
999,1991,33,Graduation,Single,86037,95,490,44,125,29,20,22,730,1,6,7,11,25
9215,1980,44,PhD,Married,43974,19,378,0,101,0,0,72,551,5,6,4,6,21
2286,1962,62,Graduation,Single,50785,27,64,1,21,0,1,27,114,2,2,1,3,8
1592,1970,54,Graduation,Married,90765,25,547,99,812,151,82,33,1724,0,4,6,5,15
367,1978,46,2n Cycle,Married,36550,74,47,90,94,123,103,120,577,5,9,1,5,20
5234,1967,57,2n Cycle,Together,30753,85,12,5,25,0,9,30,81,2,1,1,3,7
9862,1969,55,Graduation,Together,21918,37,1,6,7,11,5,3,33,2,2,0,3,7
9805,1953,71,Master,Together,56129,65,320,48,133,39,72,48,660,4,6,2,10,22
6205,1967,57,Master,Single,32557,13,34,3,29,0,4,10,80,3,2,1,3,9
8442,1985,39,Master,Married,19510,63,9,0,7,3,4,7,30,2,1,0,3,6
7386,1976,48,Graduation,Divorced,30992,83,17,0,14,7,3,2,43,1,1,0,3,5
7215,1983,41,Graduation,Single,101970,69,722,27,102,44,72,168,1135,0,6,8,13,27
1491,1965,59,2n Cycle,Together,71488,87,162,33,124,40,28,172,559,2,3,4,7,16
11071,1984,40,Graduation,Single,79607,37,450,133,951,173,0,216,1923,1,3,6,6,16
3381,1953,71,Master,Married,54348,51,70,0,16,0,0,4,90,2,2,0,4,8
8268,1961,63,PhD,Married,,23,352,0,27,10,0,15,404,3,6,1,7,17
11051,1956,68,PhD,Together,77376,72,492,19,110,16,12,12,661,4,6,3,10,23
8026,1952,72,Graduation,Married,62998,10,120,58,73,65,89,58,463,5,5,4,5,19
433,1958,66,Master,Alone,61331,42,534,5,47,0,5,41,632,5,11,1,6,23
9597,1969,55,Graduation,Married,73448,10,236,106,189,23,41,130,725,1,7,2,9,19
1295,1963,61,Graduation,Married,,96,231,65,196,38,71,124,725,1,6,5,7,19
5290,1964,60,PhD,Married,41551,51,220,0,33,3,0,23,279,5,5,1,5,16
1685,1967,57,PhD,Together,62981,21,796,14,590,38,44,0,1482,1,4,5,13,23
5342,1976,48,Basic,Divorced,9548,31,0,1,3,10,6,9,29,2,1,0,3,6
9579,1959,65,PhD,Married,33762,61,53,1,34,2,0,16,106,3,2,2,2,9
7660,1973,51,PhD,Alone,35860,37,15,0,8,4,2,20,49,2,1,1,2,6
1461,1965,59,PhD,Divorced,36921,74,17,1,12,3,1,4,38,2,2,0,3,7
821,1992,32,Master,Single,92859,46,962,61,921,52,61,20,2077,1,5,4,12,22
11084,1976,48,Master,Together,65104,4,738,0,232,13,20,50,1053,2,3,5,7,17
8690,1962,62,Graduation,Married,86111,73,399,28,756,36,40,126,1385,1,5,7,10,23
2937,1974,50,PhD,Single,68352,47,614,16,132,43,33,33,871,3,8,5,9,25
9701,1988,36,Graduation,Together,41883,13,32,34,41,73,16,116,312,3,4,2,3,12
9949,1976,48,Graduation,Married,59809,36,598,16,141,32,41,49,877,3,3,3,6,15
10837,1975,49,Graduation,Married,23957,47,2,1,18,20,11,16,68,1,2,0,3,6
3120,1981,43,Graduation,Together,38547,49,6,1,10,0,1,4,22,1,1,0,2,4
5885,1973,51,2n Cycle,Married,35688,94,73,3,90,12,1,32,211,7,4,1,4,16
4050,1966,58,Master,Married,49605,65,42,16,29,12,20,8,127,1,2,1,4,8
3830,1953,71,Master,Married,59354,59,295,21,78,39,13,13,459,1,4,4,7,16
7987,1969,55,Graduation,Married,65747,96,346,17,48,23,13,13,460,4,8,1,6,19
7798,1972,52,2n Cycle,Together,46344,28,233,20,57,8,20,91,429,4,7,1,5,17
92,1988,36,Graduation,Alone,34176,12,5,7,24,19,14,20,89,4,3,0,4,11
7055,1952,72,PhD,Together,61010,57,888,0,57,0,0,76,1021,2,8,5,11,26
10240,1949,75,Graduation,Together,69372,10,997,26,269,34,13,42,1381,1,10,4,6,21
3025,1958,66,Graduation,Single,49967,4,212,6,69,4,12,3,306,3,6,1,5,15
9283,1978,46,Graduation,Single,60199,49,8,1,7,2,0,0,18,1,0,0,3,4
9970,1977,47,Graduation,Together,55375,3,42,11,57,10,28,14,162,1,1,1,6,9
2730,1955,69,Graduation,Single,80317,64,536,11,387,149,91,57,1231,1,3,4,10,18
2795,1958,66,Master,Single,30523,0,5,0,3,0,0,5,13,1,1,0,2,4
9260,1945,79,PhD,Married,70356,20,1349,16,249,43,16,33,1706,2,10,6,9,27
8182,1984,40,Graduation,Married,23228,91,53,3,49,7,4,5,121,4,3,0,4,11
10095,1975,49,PhD,Divorced,74165,9,1001,12,240,16,12,12,1293,1,5,4,10,20
8475,1973,51,PhD,Married,157243,98,20,2,1582,1,2,1,1608,15,0,22,0,37
4370,1966,58,Graduation,Together,43482,83,18,1,32,6,3,28,88,3,2,0,4,9
10573,1953,71,Graduation,Divorced,62551,27,125,16,98,134,21,27,421,1,6,7,4,18
3712,1959,65,Graduation,Divorced,52332,63,212,5,33,7,0,2,259,1,3,2,6,12
6637,1988,36,Graduation,Single,66951,46,277,162,305,173,76,124,1117,1,3,4,7,15
3152,1957,67,Graduation,Together,26091,84,15,10,19,8,17,20,89,3,2,1,3,9
5610,1965,59,Graduation,Together,33456,58,7,3,10,8,1,7,36,2,1,0,3,6
6460,1982,42,Graduation,Married,28718,78,12,4,6,11,8,16,57,2,2,0,3,7
1349,1970,54,Graduation,Married,50447,4,85,7,24,2,3,27,148,1,3,1,3,8
1880,1959,65,PhD,Together,53537,17,81,0,6,0,0,6,93,2,2,1,3,8
641,1967,57,Graduation,Single,52074,77,59,0,12,0,0,48,119,1,2,2,2,7
8717,1975,49,PhD,Married,80427,56,1149,71,449,69,71,26,1835,1,11,8,8,28
10314,1948,76,PhD,Married,83837,79,847,66,119,86,89,111,1318,1,9,10,5,25
10854,1970,54,PhD,Married,38853,90,29,0,14,0,0,2,45,2,2,0,3,7
10492,1959,65,Graduation,Together,38285,96,2,0,5,2,0,1,10,1,0,0,3,4
6935,1951,73,2n Cycle,Married,78497,44,207,26,447,75,0,223,978,1,5,7,12,25
7698,1976,48,PhD,Married,51650,81,152,3,22,2,5,7,191,1,4,1,4,10
3559,1988,36,2n Cycle,Married,16248,77,12,11,10,3,12,9,57,3,2,1,3,9
10562,1946,78,Master,Married,66835,21,620,26,195,34,17,141,1033,1,6,4,13,24
10796,1984,40,Master,Married,30477,16,47,1,6,0,0,12,66,1,1,1,3,6
2563,1961,63,Basic,Married,28249,80,1,9,7,2,14,10,43,1,2,0,3,6
3518,1983,41,Graduation,Married,25271,45,10,1,18,10,4,7,50,1,1,1,2,5
5823,1970,54,PhD,Single,32303,63,35,0,2,0,0,2,39,2,1,0,4,7
3934,1966,58,Graduation,Married,61286,34,356,0,107,19,9,117,608,2,7,1,8,18
6982,1976,48,Graduation,Married,74068,14,783,30,537,140,76,15,1581,1,4,10,9,24
6431,1964,60,PhD,Married,45759,13,42,1,18,3,0,4,68,2,2,0,3,7
9733,1978,46,Basic,Together,24882,52,1,4,10,29,0,36,80,1,1,1,2,5
5602,1989,35,PhD,Together,66973,98,466,22,432,147,113,102,1282,1,8,7,12,28
7829,1900,124,2n Cycle,Divorced,36640,99,15,6,8,7,4,25,65,1,2,1,2,6
1324,1988,36,Graduation,Married,38872,93,23,3,21,3,19,22,91,2,3,0,3,8
326,1973,51,Graduation,Married,51148,38,235,6,45,8,9,12,315,4,5,1,6,16
7224,1977,47,Graduation,Married,31353,24,10,0,10,3,1,7,31,2,1,1,2,6
6999,1980,44,Master,Married,69661,80,656,16,106,32,16,8,834,1,7,3,12,23
9938,1954,70,Graduation,Married,80067,82,519,17,813,27,173,51,1600,1,4,6,6,17
6422,1954,70,Graduation,Married,86718,20,344,189,482,50,33,172,1270,1,5,6,5,17
3182,1973,51,PhD,Single,46854,81,96,1,79,7,1,79,263,6,5,1,3,15
7300,1952,72,Graduation,Divorced,69142,50,448,4,34,6,4,39,535,3,8,1,7,19
10424,1968,56,Graduation,Single,75922,60,265,138,553,224,23,92,1295,1,4,4,9,18
8727,1978,46,Graduation,Divorced,63693,63,587,43,337,42,87,54,1150,3,11,6,9,29
2798,1977,47,PhD,Together,102160,54,763,29,138,76,176,58,1240,0,7,9,10,26
1030,1965,59,PhD,Single,40637,72,22,0,13,0,0,3,38,2,1,0,3,6
624,1984,40,Master,Single,18890,5,6,4,1,7,2,15,35,1,0,1,2,4
5176,1988,36,Graduation,Together,29604,88,7,6,13,7,6,14,53,1,1,0,3,5
5552,1963,61,Master,Divorced,48721,50,81,18,113,47,13,21,293,6,4,2,5,17
868,1966,58,Graduation,Married,44794,99,54,0,7,0,0,4,65,1,2,0,3,6
380,1954,70,Graduation,Divorced,64497,17,1170,48,320,42,32,192,1804,5,11,4,9,29
2677,1956,68,Graduation,Together,46097,11,72,24,68,65,4,8,241,5,3,1,6,15
6521,1954,70,Graduation,Together,77972,18,613,22,319,33,102,12,1101,1,4,6,9,20
6927,1968,56,PhD,Married,44377,70,224,0,30,0,0,10,264,8,5,1,5,19
2877,1974,50,Master,Together,46014,21,410,0,59,19,9,44,541,10,7,1,8,26
0,1985,39,Graduation,Married,70951,66,239,10,554,254,87,54,1198,1,3,4,9,17
1584,1977,47,Graduation,Married,41443,79,171,7,171,25,19,89,482,6,8,1,5,20
7264,1978,46,2n Cycle,Single,52195,2,12,0,4,0,0,1,17,1,1,0,2,4
6274,1948,76,Master,Married,83790,81,1076,16,417,42,48,16,1615,1,8,10,6,25
1377,1954,70,Master,Widow,44551,24,182,4,33,0,0,66,285,2,4,1,5,12
454,1980,44,Graduation,Together,69508,48,824,32,162,42,32,43,1135,2,11,4,11,28
1755,1988,36,2n Cycle,Together,45204,93,30,11,25,29,1,18,114,1,1,1,4,7
2075,1969,55,Graduation,Married,72460,56,377,10,540,80,30,10,1047,1,3,5,7,16
4785,1970,54,PhD,Together,77622,3,520,7,154,19,0,14,714,2,6,3,11,22
9076,1980,44,PhD,Married,30732,44,155,1,25,0,1,3,185,4,4,1,4,13
7079,1962,62,Graduation,Divorced,63887,38,897,23,207,15,11,92,1245,5,9,6,12,32
4653,1978,46,Graduation,Together,42011,46,131,0,16,2,1,39,189,4,3,1,4,12
7375,1976,48,Graduation,Together,51369,84,297,7,79,0,11,182,576,2,8,2,4,16
709,1952,72,Graduation,Divorced,51537,27,787,20,204,0,0,92,1103,3,2,2,11,18
460,1972,52,PhD,Married,79930,72,792,86,740,67,51,17,1753,1,3,5,8,17
3726,1986,38,PhD,Together,34320,66,4,1,9,3,0,0,17,1,1,0,2,4
6798,1966,58,Graduation,Single,37070,30,231,7,137,4,15,39,433,9,5,1,8,23
5341,1962,62,2n Cycle,Divorced,81975,2,983,76,184,180,138,27,1588,1,6,3,4,14
1606,1971,53,Graduation,Together,38590,65,3,1,8,4,3,3,22,1,1,0,2,4
9617,1951,73,Graduation,Single,15033,37,0,4,5,6,0,4,19,1,1,0,3,5
3233,1965,59,PhD,Married,62745,89,562,21,464,28,10,32,1117,3,7,8,11,29
89,1975,49,2n Cycle,Married,22212,49,5,9,20,6,8,21,69,2,2,0,4,8
2936,1982,42,Master,Together,23661,46,18,0,4,0,0,1,23,1,1,0,3,5
9449,1958,66,PhD,Single,79761,32,415,5,124,15,35,11,605,1,5,2,11,19
7297,1973,51,Graduation,Single,7500,54,5,3,10,12,7,20,57,4,3,1,3,11
11004,1893,131,2n Cycle,Single,60182,23,8,0,5,7,0,2,22,1,1,0,2,4
313,1968,56,Graduation,Widow,73455,98,901,61,757,186,163,20,2088,1,6,5,10,22
9940,1958,66,Graduation,Together,64961,97,382,114,276,75,124,38,1009,2,6,4,4,16
10735,1971,53,Graduation,Single,22804,75,14,1,7,2,1,1,26,1,2,0,2,5
9529,1990,34,Graduation,Married,73687,8,559,153,503,218,13,181,1627,1,3,9,9,22
6439,1958,66,Graduation,Married,61074,37,789,0,133,0,28,152,1102,7,11,5,8,31
7411,1964,60,PhD,Married,31686,31,11,0,5,0,0,1,17,2,1,0,3,6
2176,1972,52,Graduation,Married,80134,40,1218,16,272,104,0,80,1690,2,5,3,6,16
9265,1953,71,Graduation,Married,75027,74,925,64,179,133,12,77,1390,2,9,4,6,21
8867,1988,36,PhD,Married,67546,90,864,134,768,150,38,172,2126,1,4,10,5,20
8932,1969,55,Master,Together,65176,57,960,28,183,220,70,70,1531,4,9,6,6,25
10236,1975,49,Master,Single,31160,59,16,3,25,6,1,13,64,2,2,0,3,7
6340,1985,39,Graduation,Single,29938,52,3,3,7,0,2,11,26,2,1,0,3,6
10089,1974,50,Graduation,Divorced,102692,5,168,148,444,32,172,148,1112,1,6,9,13,29
2227,1958,66,2n Cycle,Together,26490,92,45,47,52,21,20,25,210,2,3,1,5,11
10992,1967,57,Graduation,Together,75702,77,650,28,353,45,42,30,1148,5,4,6,11,26
5304,1974,50,PhD,Single,30899,35,24,0,8,0,0,1,33,2,1,0,3,6
309,1961,63,PhD,Together,63342,48,918,21,118,13,10,21,1101,3,8,3,5,19
3406,1964,60,Graduation,Single,45989,97,138,33,87,28,24,12,322,4,3,2,7,16
2661,1964,60,Graduation,Single,18701,95,12,4,2,10,6,10,44,4,2,0,4,10
3153,1957,67,PhD,Single,40737,24,11,0,4,0,0,2,17,1,1,0,2,4
10264,1979,45,Graduation,Divorced,15287,60,1,2,8,4,3,13,31,2,1,1,2,6
1184,1968,56,PhD,Divorced,69674,46,554,41,215,11,0,24,845,3,10,2,10,25
4200,1970,54,Master,Married,44159,85,167,2,62,24,13,7,275,4,4,1,6,15
9396,1978,46,PhD,Married,37717,31,9,0,6,4,1,5,25,1,1,0,2,4
2387,1952,72,Master,Together,43776,9,177,2,71,3,2,20,275,6,5,2,4,17
6690,1966,58,Master,Married,38179,30,38,4,22,4,2,20,90,4,3,1,3,11
1225,1963,61,Graduation,Married,80124,47,483,84,398,205,84,241,1495,1,3,7,8,19
9703,1970,54,PhD,Married,38097,70,77,2,35,0,1,69,184,4,3,2,2,11
291,1970,54,Graduation,Married,72940,13,182,74,298,162,149,116,981,1,3,3,6,13
4557,1970,54,Graduation,Together,22070,11,10,7,19,8,2,21,67,2,2,2,2,8
2379,1953,71,Graduation,Single,69267,31,778,44,499,95,73,146,1635,2,3,4,5,14
5726,1983,41,Master,Single,31788,15,16,7,23,0,8,6,60,3,3,0,4,10
3066,1975,49,PhD,Together,61905,2,167,0,43,6,2,13,231,2,4,2,4,12
6336,1960,64,Graduation,Married,29315,55,13,2,14,8,7,4,48,4,2,0,4,10
10967,1963,61,Graduation,Divorced,33378,38,33,6,40,3,7,10,99,3,2,0,4,9
2304,1963,61,PhD,Together,66313,86,625,7,99,10,22,7,770,2,6,3,12,23
3445,1956,68,Graduation,Single,60714,56,216,162,224,101,92,162,957,2,7,4,10,23
7828,1981,43,Master,Together,77882,29,68,129,396,188,22,15,818,1,3,3,5,12
3762,1986,38,PhD,Single,69867,30,196,0,512,33,130,54,925,1,3,5,8,17
4391,1968,56,Master,Divorced,63841,64,635,15,100,20,7,131,908,1,9,3,9,22
4669,1981,43,Basic,Married,24480,46,4,19,9,28,25,17,102,3,3,0,4,10
10144,1976,48,Graduation,Together,51369,84,297,7,79,0,11,182,576,2,8,2,4,16
8652,1946,78,Graduation,Together,37760,20,84,5,38,150,12,28,317,2,4,1,6,13
1672,1974,50,PhD,Together,65640,74,204,7,149,20,15,66,461,1,5,1,8,15
8962,1975,49,Master,Married,44319,18,26,0,8,0,0,3,37,2,2,0,3,7
9974,1974,50,Graduation,Married,30631,75,15,6,20,4,5,20,70,1,3,1,2,7
10983,1952,72,Graduation,Together,75278,17,304,98,230,150,74,74,930,1,6,3,13,23
8148,1956,68,Master,Together,50898,88,285,28,242,55,114,135,859,13,6,2,12,33
10102,1966,58,Graduation,Widow,79946,19,395,183,565,166,141,28,1478,1,5,11,5,22
4697,1949,75,Master,Divorced,35416,62,248,3,81,4,3,51,390,3,7,1,5,16
9262,1984,40,2n Cycle,Together,32414,11,20,6,5,0,9,12,52,1,1,0,3,5
7254,1969,55,Graduation,Together,38361,74,39,0,56,20,8,14,137,3,3,1,3,10
4543,1980,44,Graduation,Married,82497,32,777,129,573,216,21,203,1919,1,2,7,9,19
4927,1971,53,Graduation,Together,16626,76,8,3,22,21,1,13,68,3,3,0,3,9
10451,1965,59,Graduation,Together,29672,6,9,1,3,0,4,8,25,1,0,0,3,4
2926,1952,72,Master,Together,55951,62,1241,0,80,0,13,40,1374,3,3,6,11,23
2874,1988,36,2n Cycle,Divorced,35388,20,6,4,7,4,3,8,32,1,1,0,3,5
9738,1986,38,Master,Together,42386,43,65,4,16,0,4,11,100,1,3,0,3,7
7119,1982,42,Graduation,Single,68627,45,395,15,263,60,54,38,825,1,2,3,6,12
3924,1965,59,PhD,Divorced,57912,34,801,0,80,0,0,35,916,5,8,3,12,28
5827,1958,66,Graduation,Divorced,35246,53,36,0,12,2,2,10,62,4,3,1,3,11
5596,1956,68,2n Cycle,Together,58821,44,513,14,154,19,0,28,728,1,9,2,9,21
10812,1978,46,PhD,Married,46377,89,37,0,46,4,3,0,90,1,2,1,3,7
1717,1988,36,Graduation,Single,39747,43,80,15,93,20,13,52,273,3,5,1,4,13
9491,1984,40,Graduation,Together,23976,68,14,1,21,2,3,25,66,3,3,1,3,10
9274,1961,63,Master,Married,80950,44,525,147,112,219,147,63,1213,1,6,7,9,23
6609,1966,58,Graduation,Widow,27038,64,1,26,25,17,23,15,107,1,3,0,3,7
6963,1947,77,Graduation,Single,77457,85,675,11,400,15,45,11,1157,1,2,5,10,18
4440,1964,60,Master,Married,64100,93,509,0,27,0,0,10,546,1,8,3,6,18
1379,1992,32,Master,Together,42670,12,154,2,46,20,4,15,241,1,4,2,4,11
10032,1976,48,Graduation,Divorced,12571,86,3,5,14,2,12,17,53,4,3,1,3,11
2826,1967,57,Graduation,Married,22574,28,25,0,8,2,0,2,37,2,2,0,3,7
2437,1989,35,Graduation,Married,,69,861,138,461,60,30,61,1611,1,6,5,12,24
6320,1976,48,Master,Single,70893,42,768,44,561,77,44,14,1508,1,6,6,10,23
3050,1966,58,Graduation,Married,54198,13,185,0,28,3,2,17,235,6,3,1,6,16
231,1956,68,Master,Together,28839,86,24,0,7,0,0,1,32,2,2,0,3,7
2392,1972,52,Graduation,Married,40321,59,44,4,21,6,0,27,102,2,3,0,3,8
9478,1985,39,Graduation,Single,66503,30,91,64,128,65,3,50,401,2,4,3,6,15
113,1951,73,Graduation,Married,30833,33,11,0,7,3,1,6,28,2,1,0,3,6
2863,1970,54,Graduation,Single,,67,738,20,172,52,50,20,1052,6,2,3,10,21
1802,1971,53,Graduation,Married,64795,23,412,5,119,38,29,77,680,3,3,3,12,21
520,1974,50,Graduation,Married,34421,81,3,3,7,6,2,9,30,1,1,0,2,4
8275,1965,59,PhD,Divorced,47025,6,16,0,3,0,0,1,20,1,1,0,2,4
9750,1961,63,PhD,Divorced,64325,41,731,60,353,78,12,73,1307,5,10,3,5,23
2607,1953,71,Graduation,Single,40464,78,424,17,118,7,23,41,630,6,8,2,8,24
7214,1957,67,Graduation,Married,62187,49,792,0,275,45,45,126,1283,1,4,8,5,18
5835,1976,48,PhD,Divorced,14849,39,21,2,28,3,2,9,65,3,2,0,4,9
3896,1984,40,Graduation,Married,27255,3,22,1,11,0,1,2,37,1,1,0,3,5
10350,1950,74,PhD,Married,54432,37,33,0,5,0,0,0,38,1,1,0,3,5
7786,1986,38,PhD,Single,29999,22,68,7,59,10,5,11,160,4,3,1,4,12
2861,1983,41,Graduation,Single,24072,79,9,1,6,3,0,4,23,1,1,0,2,4
663,1989,35,PhD,Single,33996,46,40,2,15,8,0,6,71,1,1,1,3,6
10675,1956,68,PhD,Married,66334,82,909,11,218,0,0,23,1161,2,9,3,5,19
2521,1971,53,Master,Married,35178,10,23,1,13,2,2,18,59,1,1,1,2,5
9592,1983,41,Graduation,Together,22010,51,11,2,9,3,0,8,33,2,2,0,3,7
10151,1960,64,Graduation,Divorced,62204,38,317,46,247,151,46,139,946,1,4,5,12,22
7381,1968,56,Graduation,Divorced,75693,10,797,153,293,72,97,30,1442,1,11,4,6,22
4099,1972,52,Graduation,Married,30675,14,10,2,16,11,2,21,62,1,1,0,3,5
9560,1965,59,Graduation,Together,83003,18,856,61,570,40,25,122,1674,1,7,6,8,22
1150,1899,125,PhD,Together,83532,36,755,144,562,104,64,224,1853,1,4,6,4,15
10172,1988,36,Graduation,Single,68655,95,456,19,832,75,118,38,1538,1,4,5,11,21
11191,1986,38,Graduation,Divorced,41411,11,37,32,38,11,3,18,139,1,2,1,4,8
9707,1969,55,PhD,Married,55212,65,1103,0,45,0,0,34,1182,3,4,2,11,20
6245,1950,74,PhD,Together,59292,71,378,14,68,19,14,14,507,2,3,5,8,18
8234,1973,51,Basic,Together,27190,13,1,6,7,0,1,3,18,1,1,0,2,4
1411,1952,72,Graduation,Divorced,82623,58,204,34,204,172,153,173,940,1,2,9,4,16
8553,1965,59,Graduation,Married,44300,65,30,0,9,0,0,3,42,2,1,0,3,6
1826,1970,54,Graduation,Divorced,84835,0,189,104,379,111,189,218,1190,1,4,4,6,15
8842,1971,53,Graduation,Widow,30372,33,15,0,12,7,3,7,44,3,2,0,3,8
11030,1976,48,Master,Married,33181,90,9,0,3,0,0,4,16,1,1,0,2,4
2579,1957,67,Graduation,Married,71113,95,495,33,255,11,33,8,835,4,6,7,9,26
175,1986,38,Graduation,Married,71952,93,656,80,455,52,107,93,1443,2,8,4,8,22
9185,1966,58,PhD,Single,69759,38,452,20,514,13,30,0,1029,3,4,6,5,18
11056,1974,50,Graduation,Married,72099,18,546,91,410,119,0,22,1188,1,3,4,10,18
9365,1976,48,PhD,Single,60000,57,1048,0,217,0,0,12,1277,5,11,3,5,24
6201,1978,46,Graduation,Single,38643,45,22,2,14,0,1,10,49,2,2,0,3,7
2061,1955,69,Graduation,Married,50737,61,78,0,11,0,0,10,99,1,2,0,4,7
6184,1969,55,PhD,Married,68462,6,561,64,785,84,128,48,1670,1,3,3,8,15
6142,1943,81,Master,Married,65073,65,629,17,177,69,0,8,900,1,5,3,5,14
4107,1948,76,PhD,Together,46681,52,269,15,69,15,19,38,425,2,4,6,4,16
7274,1957,67,Graduation,Married,78618,87,736,163,818,212,163,61,2153,1,4,7,10,22
9336,1969,55,PhD,Widow,62187,38,512,0,83,0,0,41,636,3,6,2,10,21
2958,1978,46,Graduation,Married,28442,53,19,3,10,11,8,6,57,3,2,1,4,10
933,1978,46,PhD,Married,37717,31,9,0,6,4,1,5,25,1,1,0,2,4
5837,1967,57,Graduation,Married,51479,67,247,8,160,6,8,65,494,7,6,3,6,22
10704,1969,55,Graduation,Single,54803,65,404,0,92,28,27,142,693,2,6,2,9,19
5125,1960,64,Graduation,Married,79530,64,333,0,815,129,42,29,1348,1,4,10,11,26
4432,1976,48,Graduation,Divorced,31615,82,2,3,20,6,11,9,51,2,2,0,3,7
5955,1962,62,Graduation,Together,72025,27,833,33,549,151,133,233,1932,1,4,3,8,16
2928,1975,49,PhD,Single,52614,63,789,0,142,12,9,38,990,2,2,4,8,16
5680,1984,40,2n Cycle,Married,35684,66,10,4,7,0,6,3,30,1,1,0,3,5
10313,1975,49,Graduation,Married,48178,69,159,4,45,6,2,38,254,6,5,1,4,16
2557,1970,54,Master,Single,29548,52,7,1,6,3,1,11,29,1,1,1,2,5
1245,1966,58,Graduation,Single,63810,45,977,12,253,16,12,101,1371,4,4,3,12,23
1519,1972,52,PhD,Single,38578,2,38,4,22,3,3,3,73,3,3,0,3,9
10703,1975,49,Master,Single,46098,86,57,0,27,0,0,36,120,4,3,2,2,11
1726,1970,54,Graduation,Single,22585,23,3,9,15,13,2,39,81,1,1,1,2,5
4459,1989,35,Graduation,Single,30279,13,10,4,14,4,4,1,37,1,1,0,3,5
1729,1961,63,PhD,Together,66426,14,1043,24,97,32,24,157,1377,2,3,5,10,20
1517,1969,55,Graduation,Single,30822,92,3,9,13,2,12,12,51,1,1,0,3,5
2098,1969,55,PhD,Married,33581,38,11,0,5,0,0,1,17,1,1,0,2,4
9543,1985,39,Graduation,Married,19986,74,3,6,5,0,2,6,22,1,0,0,3,4
6878,1954,70,Graduation,Widow,27421,14,43,12,96,78,40,55,324,3,4,1,6,14
3310,1973,51,2n Cycle,Married,35688,94,73,3,90,12,1,32,211,7,4,1,4,16
2724,1981,43,Master,Single,36143,33,12,0,1,0,0,6,19,1,0,1,2,4
948,1971,53,Graduation,Single,10245,32,4,7,7,6,4,13,41,3,1,2,2,8
6720,1968,56,Master,Together,43795,11,314,11,53,4,3,107,492,3,7,3,4,17
6202,1960,64,Graduation,Together,63381,78,571,50,142,33,50,159,1005,4,4,5,13,26
2066,1949,75,Graduation,Together,38823,56,70,0,11,2,8,23,114,1,2,1,3,7
9799,1968,56,PhD,Divorced,83664,57,866,21,151,28,21,86,1173,3,2,2,12,19
8318,1979,45,Graduation,Together,90300,7,594,134,786,33,134,57,1738,0,5,6,8,19
5642,1979,45,Master,Together,62499,0,140,4,61,0,13,4,222,2,3,1,6,12
2669,1993,31,Graduation,Single,74293,66,375,152,335,93,91,81,1127,1,5,4,6,16
455,1946,78,PhD,Married,51012,86,102,9,63,2,9,24,209,1,4,1,4,10
7683,1968,56,Master,Married,70777,80,554,35,113,0,7,78,787,3,5,3,12,23
3428,1991,33,PhD,Together,68682,56,919,0,505,99,30,45,1598,1,4,9,10,24
7414,1971,53,Graduation,Married,43824,18,96,1,42,12,3,32,186,4,3,1,4,12
6354,1984,40,Graduation,Together,15345,51,5,2,16,3,2,19,47,2,1,1,2,6
798,1987,37,Graduation,Single,23442,71,2,0,6,8,6,5,27,1,1,0,3,5
8213,1980,44,2n Cycle,Together,14515,71,6,4,9,6,36,35,96,4,2,2,3,11
2488,1956,68,2n Cycle,Divorced,31395,80,23,1,25,0,8,7,64,4,2,1,3,10
9999,1965,59,Graduation,Together,75276,2,610,105,125,137,42,21,1040,1,9,4,9,23
7617,1974,50,Graduation,Single,42373,83,67,5,61,3,8,19,163,5,2,1,5,13
615,1960,64,Graduation,Together,30507,29,65,36,74,38,20,110,343,1,5,1,4,11
2552,1955,69,PhD,Single,55521,11,416,0,26,0,0,4,446,9,6,3,6,24
194,1965,59,Graduation,Married,48006,55,23,0,11,3,2,2,41,1,1,0,3,5
3645,1972,52,PhD,Single,27213,19,19,3,26,10,9,3,70,3,2,0,4,9
8890,1971,53,PhD,Divorced,65808,1,155,7,80,13,7,10,272,3,5,1,5,14
5049,1974,50,PhD,Together,30351,19,14,0,24,3,3,2,46,1,3,0,2,6
9973,1963,61,Graduation,Married,50437,28,370,9,92,6,9,4,490,3,7,1,8,19
7301,1982,42,2n Cycle,Single,23616,76,4,22,11,3,7,32,79,2,3,0,3,8
10882,1976,48,Graduation,Married,53858,50,407,53,221,58,150,26,915,4,4,3,6,17
7030,1955,69,PhD,Married,66465,1,1200,0,204,38,29,14,1485,3,11,9,12,35
7422,1987,37,Graduation,Single,46923,90,85,44,54,102,78,6,369,3,5,1,7,16
3523,1962,62,Graduation,Together,75072,83,583,34,309,0,22,125,1073,2,5,4,8,19
7106,1943,81,PhD,Married,75865,73,483,0,591,156,0,12,1242,1,3,5,10,19
6504,1975,49,2n Cycle,Together,19789,24,2,5,9,28,6,28,78,3,2,1,3,9
5067,1994,30,Graduation,Together,80134,11,966,26,282,52,26,26,1378,1,2,7,11,21
4216,1981,43,Graduation,Single,91065,33,822,114,108,179,137,114,1474,1,7,9,9,26
8581,1971,53,Master,Married,49505,4,604,0,100,19,0,28,751,9,10,2,8,29
5929,1973,51,PhD,Married,37401,14,19,3,19,3,1,3,48,2,2,0,3,7
3129,1983,41,Graduation,Married,30096,30,5,3,11,12,5,9,45,1,2,0,3,6
6528,1982,42,Master,Together,18492,75,2,2,2,2,1,1,10,1,1,0,2,4
1361,1974,50,Master,Married,82584,26,1076,68,103,29,91,68,1435,1,3,4,8,16
6932,1941,83,PhD,Married,93027,77,1285,42,716,55,0,21,2119,0,7,10,5,22
7284,1953,71,Graduation,Married,48686,8,10,0,7,2,0,1,20,1,1,0,2,4
1340,1986,38,Graduation,Married,92910,42,551,137,792,179,103,33,1795,1,6,7,13,27
8746,1989,35,Graduation,Married,75433,28,800,0,297,0,34,57,1188,2,2,5,10,19
5987,1989,35,2n Cycle,Together,10404,52,2,2,11,10,6,12,43,2,1,0,4,7
3767,1968,56,Graduation,Married,61314,1,378,0,189,97,172,172,1008,2,5,5,12,24
3725,1961,63,PhD,Single,84865,1,1248,16,349,43,16,16,1688,1,2,4,9,16
4324,1989,35,Graduation,Married,42387,42,235,0,235,19,4,191,684,5,8,1,7,21
238,1967,57,2n Cycle,Together,67309,76,515,47,181,149,95,95,1082,15,9,6,9,39
6694,1964,60,Graduation,Married,75236,27,438,66,400,12,38,114,1068,1,8,3,13,25
498,1970,54,Graduation,Single,30015,28,25,0,22,2,3,5,57,2,1,0,4,7
9347,1956,68,Master,Together,50943,49,31,0,7,2,0,6,46,1,1,0,3,5
9699,1966,58,Graduation,Divorced,67272,12,357,35,271,28,28,14,733,3,6,2,12,23
10664,1949,75,Master,Widow,51529,14,400,4,35,6,0,22,467,2,9,1,5,17
5455,1971,53,PhD,Married,32011,89,99,0,15,2,1,5,122,3,2,1,4,10
456,1986,38,2n Cycle,Married,7500,96,1,11,5,4,6,9,36,2,2,0,3,7
5012,1989,35,Graduation,Married,28691,56,5,4,13,8,0,4,34,1,1,0,3,5
7495,1948,76,PhD,Married,56223,72,77,28,31,16,0,4,156,2,2,1,5,10
5029,1946,78,Graduation,Married,18100,14,3,1,2,4,3,1,14,1,0,0,3,4
10642,1989,35,Graduation,Single,30279,13,10,4,14,4,4,1,37,1,1,0,3,5
2106,1974,50,2n Cycle,Married,20130,99,0,6,3,7,6,12,34,1,1,0,3,5
10364,1959,65,Graduation,Divorced,23295,72,0,0,1,2,12,5,20,1,1,0,2,4
5954,1972,52,Master,Divorced,42618,92,76,14,74,13,5,10,192,2,5,0,4,11
1137,1964,60,Graduation,Single,81246,87,398,190,537,61,156,37,1379,1,4,5,7,17
2541,1976,48,Graduation,Married,24027,7,14,7,11,11,0,5,48,2,2,0,3,7
1142,1953,71,PhD,Married,55707,91,208,7,82,30,66,35,428,2,3,2,9,16
2276,1955,69,Graduation,Single,57959,71,430,16,322,43,24,33,868,5,4,7,11,27
2807,1969,55,Graduation,Married,56796,24,656,38,161,62,47,37,1001,3,8,9,7,27
6471,1971,53,Master,Single,36230,17,14,2,30,8,2,3,59,1,2,0,4,7
6131,1980,44,2n Cycle,Married,70829,87,141,70,106,72,19,23,431,2,4,2,8,16
6233,1976,48,Graduation,Married,65991,21,507,19,364,25,47,9,971,3,9,5,10,27
4148,1972,52,Graduation,Married,38988,90,164,24,103,12,3,42,348,7,5,1,6,19
4947,1966,58,2n Cycle,Single,89572,44,606,24,974,197,194,64,2059,1,7,7,9,24
3225,1984,40,Master,Married,42207,71,116,11,72,3,17,46,265,4,4,1,5,14
7540,1952,72,Graduation,Married,50300,52,143,15,60,24,23,5,270,2,2,1,8,13
10648,1982,42,2n Cycle,Together,66664,78,398,96,447,220,96,32,1289,1,5,7,6,19
1992,1964,60,Graduation,Married,60597,2,522,0,257,32,16,66,893,4,2,2,8,16
7851,1949,75,Graduation,Widow,70165,60,161,0,253,199,191,122,926,1,3,7,11,22
8594,1958,66,PhD,Widow,50520,25,112,0,6,2,1,14,135,2,3,1,3,9
7059,1963,61,Graduation,Married,80124,47,483,84,398,205,84,241,1495,1,3,7,8,19
2815,1975,49,Graduation,Married,33183,46,7,5,39,17,15,37,120,2,4,0,3,9
2416,1969,55,PhD,Single,66582,83,789,25,420,16,38,0,1288,1,2,8,9,20
7999,1955,69,PhD,Together,75261,17,1239,17,413,23,34,17,1743,1,5,6,5,17
9213,1970,54,Graduation,Widow,31880,13,4,1,5,2,0,3,15,1,1,0,2,4
9697,1951,73,Graduation,Married,53790,86,335,42,127,28,5,5,542,3,7,2,8,20
3916,1971,53,PhD,Together,49269,92,639,8,166,11,8,58,890,3,7,3,12,25
2021,1975,49,Graduation,Married,61456,47,563,76,384,84,192,89,1388,4,6,10,13,33
1581,1980,44,Graduation,Married,37406,18,2,0,8,2,2,3,17,1,1,0,2,4
564,1981,43,PhD,Together,56937,81,746,8,125,11,8,8,906,7,8,6,9,30
6619,1978,46,Graduation,Married,38415,91,22,1,13,4,0,4,44,2,1,0,3,6
9081,1988,36,Graduation,Single,20518,58,4,1,6,4,1,9,25,1,1,1,2,5
178,1956,68,Graduation,Married,62503,40,478,0,193,110,75,117,973,4,8,3,11,26
916,1972,52,PhD,Single,41644,67,20,3,4,2,0,2,31,2,1,0,3,6
5512,1977,47,Master,Married,55842,19,451,0,39,0,4,24,518,1,7,1,8,17
8970,1972,52,PhD,Married,62010,93,371,22,39,6,0,92,530,4,6,2,7,19
10581,1977,47,Graduation,Married,41124,41,281,7,84,15,0,119,506,7,7,3,4,21
5300,1973,51,Master,Married,38961,60,19,7,19,0,1,24,70,1,2,1,2,6
5154,1972,52,Master,Divorced,37760,54,26,3,13,2,10,0,54,1,2,0,3,6
8346,1974,50,Graduation,Single,32233,26,138,15,35,25,11,72,296,2,6,2,2,12
1676,1975,49,Graduation,Married,43057,30,213,2,44,0,2,5,266,4,4,2,5,15
9286,1960,64,Master,Together,83151,93,407,28,100,120,74,18,747,1,5,9,4,19
2426,1964,60,PhD,Divorced,78825,35,483,74,114,169,37,18,895,1,5,10,13,29
5172,1976,48,Master,Together,65104,4,738,0,232,13,20,50,1053,2,3,5,7,17
5562,1974,50,Graduation,Married,60093,92,502,12,109,16,6,90,735,2,7,2,10,21
3436,1969,55,Graduation,Married,14045,24,11,0,5,2,1,1,20,1,1,0,3,5
3921,1952,72,2n Cycle,Widow,28457,96,24,1,108,29,29,14,205,1,4,1,4,10
3403,1958,66,PhD,Together,78952,11,1170,19,594,99,76,134,2092,2,2,5,12,21
22,1976,48,Graduation,Divorced,46310,99,185,2,88,15,5,14,309,2,6,1,5,14
10965,1955,69,Graduation,Together,76005,72,983,20,389,240,50,40,1722,1,3,5,13,22
9426,1964,60,Master,Single,58308,77,691,0,69,10,0,130,900,4,2,6,3,15
6605,1944,80,PhD,Divorced,55614,85,504,13,131,8,0,26,682,1,9,4,6,20
3136,1962,62,Master,Divorced,59432,88,317,25,265,25,19,12,663,3,5,3,11,22
8737,1978,46,Graduation,Divorced,55563,22,29,1,9,2,0,2,43,1,2,0,3,6
11088,1971,53,PhD,Together,78642,83,1396,0,322,46,35,17,1816,1,4,9,4,18
716,1949,75,PhD,Together,67911,63,529,0,356,63,28,0,976,3,6,7,11,27
466,1944,80,Graduation,Married,65275,9,388,14,218,91,14,21,746,1,4,3,13,21
9135,1950,74,Graduation,Together,27203,92,13,2,21,4,0,24,64,2,1,1,2,6
10623,1961,63,Master,Together,48330,2,28,0,4,0,0,0,32,1,1,0,3,5
8151,1990,34,Basic,Married,24279,6,16,36,21,20,62,108,263,1,4,1,3,9
5140,1985,39,PhD,Married,64355,66,1047,0,140,67,38,153,1445,2,4,3,12,21
10160,1956,68,Master,Together,50943,49,31,0,7,2,0,6,46,1,1,0,3,5
4945,1953,71,Graduation,Widow,53653,29,815,10,239,28,10,108,1210,2,10,4,12,28
10584,1976,48,Graduation,Married,65665,77,225,162,387,106,36,29,945,1,5,10,8,24
6071,1989,35,Graduation,Single,81217,77,493,70,324,146,40,84,1157,1,3,7,11,22
3386,1992,32,Graduation,Married,34935,71,34,4,66,3,10,20,137,1,2,1,4,8
8939,1959,65,Graduation,Divorced,61250,49,382,138,65,60,26,59,730,6,5,2,12,25
9925,1981,43,PhD,Together,39665,97,127,1,56,0,1,31,216,3,4,2,3,12
4320,1979,45,Graduation,Single,60152,6,325,83,300,86,58,91,943,1,6,4,12,23
5389,1964,60,Graduation,Married,48920,93,238,17,68,8,10,6,347,3,6,2,5,16
6036,1959,65,Master,Together,89120,78,1168,92,408,72,129,55,1924,1,5,6,7,19
182,1946,78,PhD,Together,44124,62,284,0,55,0,6,52,397,4,6,2,5,17
203,1975,49,Master,Single,81169,47,1288,20,613,80,61,27,2089,1,5,7,9,22
11025,1961,63,Graduation,Married,36443,9,65,0,46,4,3,20,138,4,3,1,3,11
10203,1990,34,Graduation,Single,26095,77,11,7,9,3,1,11,42,1,1,0,3,5
4607,1959,65,Graduation,Together,71367,24,227,23,389,42,21,75,777,1,4,5,7,17
3711,1944,80,Master,Married,80184,19,1035,134,670,25,38,0,1902,1,6,3,10,20
3696,1965,59,Graduation,Divorced,30630,67,27,1,12,2,0,10,52,2,2,0,3,7
2532,1987,37,Master,Single,73454,95,982,73,351,56,14,175,1651,1,2,4,6,13
9214,1991,33,Graduation,Married,42691,48,179,2,64,38,17,58,358,1,5,1,6,13
4943,1953,71,Graduation,Married,70503,73,1379,33,216,0,33,66,1727,1,2,4,9,16
35,1987,37,Graduation,Married,25545,35,32,1,64,16,12,85,210,3,2,2,3,10
2258,1986,38,Graduation,Married,32880,76,8,4,15,7,6,2,42,1,1,0,3,5
4322,1958,66,PhD,Together,77863,20,881,38,319,16,25,12,1291,1,4,5,10,20
713,1977,47,Master,Married,50353,72,141,15,153,67,31,35,442,1,4,4,6,15
4702,1964,60,Graduation,Single,61839,20,1000,155,379,224,17,120,1895,1,4,8,4,17
3281,1960,64,PhD,Married,49154,69,206,10,67,30,27,71,411,6,4,1,8,19
702,1975,49,2n Cycle,Widow,47682,80,162,61,83,97,57,61,521,4,4,3,8,19
2004,1969,55,Graduation,Single,72679,65,619,54,260,127,54,54,1168,1,4,7,5,17
4769,1977,47,Master,Together,57954,52,456,4,24,0,0,9,493,7,8,2,6,23
4437,1962,62,Graduation,Married,65316,65,112,6,92,3,9,38,260,2,3,2,5,12
8724,1982,42,Graduation,Single,28567,57,11,3,22,2,2,6,46,2,2,0,3,7
10741,1951,73,Master,Together,47352,70,172,12,112,8,0,15,319,4,6,1,5,16
1991,1967,57,Graduation,Together,44931,0,78,0,11,0,0,7,96,1,2,1,3,7
6931,1967,57,Graduation,Divorced,76982,19,464,151,292,65,60,30,1062,1,8,3,4,16
11096,1952,72,2n Cycle,Together,57247,50,99,4,32,37,54,6,232,2,2,1,7,12
304,1981,43,Master,Single,22944,67,19,3,19,4,5,26,76,3,3,0,3,9
3665,1977,47,2n Cycle,Together,25315,46,1,9,8,11,3,22,54,3,3,0,3,9
10591,1969,55,Graduation,Widow,43638,37,63,10,83,7,19,19,201,2,4,1,4,11
5036,1984,40,PhD,Single,42710,38,252,3,42,4,3,102,406,2,4,5,3,14
5547,1982,42,PhD,Married,84169,9,1478,19,403,0,19,0,1919,1,7,6,6,20
7822,1976,48,Graduation,Together,54058,56,198,18,252,32,108,54,662,2,4,6,8,20
8541,1990,34,2n Cycle,Married,24683,98,8,4,10,6,7,6,41,2,2,0,4,8
10955,1964,60,Graduation,Widow,85620,68,416,46,925,60,107,46,1600,1,3,6,4,14
4368,1980,44,Graduation,Married,47850,72,42,7,43,20,12,10,134,1,3,0,4,8
9671,1968,56,Graduation,Married,19514,47,14,3,21,2,1,28,69,4,3,1,2,10
2256,1973,51,Master,Married,27159,33,17,0,3,0,0,1,21,2,1,0,3,6
4279,1963,61,2n Cycle,Single,39548,87,15,4,10,3,4,18,54,2,1,1,3,7
5371,1989,35,Graduation,Single,21474,0,6,16,24,11,0,34,91,2,3,1,2,8
9240,1971,53,PhD,Single,60504,73,458,0,24,6,4,34,526,2,6,2,8,18
9460,1963,61,Graduation,Married,22419,74,30,3,47,19,21,42,162,1,3,2,2,8
9504,1949,75,Master,Married,81698,4,179,28,520,111,123,47,1008,1,3,8,13,25
8692,1952,72,Graduation,Together,43462,50,90,17,97,15,6,15,240,6,4,1,5,16
448,1978,46,PhD,Single,54880,57,308,85,137,102,45,118,795,2,6,2,11,21
8314,1982,42,Graduation,Married,79908,30,557,129,761,29,185,111,1772,1,5,6,7,19
8420,1970,54,2n Cycle,Married,15315,27,7,4,13,15,8,17,64,2,2,0,4,8
3174,1959,65,Graduation,Together,87771,61,1492,38,287,50,57,33,1957,1,5,10,4,20
7685,1978,46,Graduation,Married,33039,4,30,8,12,8,8,12,78,1,2,0,4,7
3179,1980,44,Graduation,Single,81741,75,249,153,940,58,134,38,1572,0,6,6,7,19
9780,1971,53,Master,Together,71499,12,465,25,132,136,0,37,795,2,8,3,13,26
10681,1970,54,2n Cycle,Married,62466,13,129,129,259,168,121,83,889,5,6,3,12,26
10232,1963,61,PhD,Divorced,48799,9,174,18,81,28,6,24,331,3,3,2,7,15
4184,1950,74,PhD,Together,52157,48,189,2,29,3,2,40,265,2,3,2,5,12
9120,1962,62,Graduation,Single,66565,80,747,10,161,65,40,42,1065,4,4,2,9,19
891,1951,73,Master,Together,29298,60,6,0,2,2,0,1,11,1,1,0,2,4
10381,1979,45,Graduation,Single,47691,43,14,0,3,0,0,4,21,1,1,0,2,4
3525,1970,54,Graduation,Together,38200,19,12,0,4,0,0,1,17,1,1,0,2,4
6818,1974,50,Graduation,Married,44989,26,98,0,106,49,10,106,369,5,5,1,5,16
3526,1968,56,PhD,Married,38443,58,32,0,5,0,0,1,38,2,1,0,3,6
8181,1978,46,2n Cycle,Single,38593,42,51,12,49,17,24,24,177,3,4,1,3,11
1029,1970,54,PhD,Together,64413,27,200,5,44,0,10,20,279,1,5,1,5,12
7369,1981,43,Master,Married,36959,56,25,6,25,6,0,0,62,2,2,0,3,7
2574,1977,47,PhD,Married,61996,27,1050,12,144,0,0,24,1230,3,6,4,8,21
8159,1968,56,Graduation,Married,51287,10,117,0,22,13,0,30,182,3,4,1,3,11
1160,1970,54,Graduation,Married,13260,48,9,4,17,10,2,7,49,4,3,0,3,10
10242,1966,58,PhD,Together,47472,39,56,0,11,0,0,8,75,2,2,0,4,8
5253,1956,68,Master,Together,54603,85,145,13,46,17,2,4,227,6,4,2,4,16
5966,1974,50,PhD,Married,45207,64,203,0,10,0,0,2,215,5,3,1,6,15
5314,1951,73,Graduation,Together,40689,69,270,3,27,39,6,99,444,7,7,1,5,20
5081,1967,57,2n Cycle,Together,47821,54,9,0,16,6,6,10,47,1,1,0,3,5
5123,1951,73,Master,Married,27450,57,37,12,23,8,11,52,143,1,2,1,3,7
5756,1983,41,Graduation,Together,39453,64,46,0,7,0,0,2,55,2,2,0,3,7
8036,1971,53,2n Cycle,Together,26850,10,31,1,13,7,2,9,63,4,2,1,4,11
9058,1955,69,Graduation,Widow,79800,65,1060,21,530,32,0,224,1867,1,5,11,5,22
5057,1961,63,Master,Married,61794,74,264,47,188,54,47,11,611,2,4,4,10,20
254,1955,69,Graduation,Together,53863,4,399,4,30,6,4,30,473,3,7,1,7,18
4179,1959,65,Graduation,Together,24221,94,8,9,9,2,5,22,55,1,1,1,3,6
3710,1984,40,PhD,Single,39684,41,19,0,35,6,4,17,81,2,2,1,2,7
7627,1975,49,Master,Married,92163,25,817,183,797,106,163,20,2086,0,5,11,5,21
4501,1965,59,Master,Single,69882,94,292,127,635,132,127,165,1478,1,3,7,9,20
6424,1977,47,Graduation,Together,33178,9,12,6,2,11,2,16,49,1,1,0,3,5
3075,1972,52,PhD,Married,59973,47,130,30,168,20,34,0,382,1,3,4,7,15
4992,1975,49,Master,Together,17459,12,6,4,16,3,10,30,69,3,3,1,2,9
5252,1969,55,Graduation,Divorced,23910,80,16,12,18,7,1,13,67,1,2,0,3,6
7444,1969,55,Master,Married,42169,20,19,0,9,0,0,2,30,2,1,0,3,6
6919,1978,46,2n Cycle,Married,26224,39,4,7,15,13,9,15,63,3,2,1,3,9
3537,1981,43,Graduation,Together,31089,57,31,3,31,2,8,4,79,3,3,0,4,10
10277,1961,63,Graduation,Single,30081,27,36,0,2,0,0,4,42,1,1,0,3,5
2453,1960,64,Graduation,Together,62807,83,526,28,135,10,21,99,819,3,5,3,12,23
7972,1955,69,Graduation,Single,72906,79,400,32,519,71,75,54,1151,1,3,4,9,17
895,1948,76,PhD,Married,61467,69,410,16,114,0,5,49,594,3,5,2,10,20
1177,1966,58,Master,Together,49618,77,80,3,26,4,2,14,129,4,3,1,3,11
7141,1986,38,Master,Single,21888,15,88,10,46,2,3,64,213,4,5,1,2,12
7232,1973,51,Graduation,Widow,42429,99,55,0,6,2,0,4,67,2,1,1,3,7
8477,1956,68,Graduation,Divorced,26150,61,5,1,13,3,5,1,28,1,1,0,3,5
2457,1975,49,Basic,Married,30801,23,8,4,5,15,2,11,45,2,1,0,3,6
988,1965,59,Graduation,Married,81168,84,410,0,592,147,22,22,1193,1,6,4,7,18
7930,1969,55,Master,Single,26877,74,101,13,76,20,18,40,268,2,3,1,6,12
4587,1944,80,Master,Widow,45006,90,162,25,53,16,0,10,266,1,3,1,7,12
6682,1973,51,Basic,Married,18978,41,2,8,1,4,7,15,37,1,1,0,3,5
6222,1967,57,Graduation,Married,22574,28,25,0,8,2,0,2,37,2,2,0,3,7
10299,1969,55,PhD,Single,48240,73,389,91,248,64,49,41,882,3,6,3,13,25
3083,1974,50,Graduation,Married,45837,88,215,13,87,17,17,24,373,5,6,2,5,18
8953,1965,59,Master,Single,35791,94,27,0,5,0,0,3,35,2,1,0,3,6
1503,1976,48,PhD,Together,162397,31,85,1,16,2,1,2,107,0,0,0,1,1
8650,1978,46,Graduation,Widow,54162,31,5,6,10,6,5,10,42,1,1,0,3,5
10862,1960,64,Master,Married,30522,6,179,8,83,19,11,26,326,5,1,2,9,17
2782,1961,63,PhD,Married,54456,23,352,0,27,10,0,15,404,3,6,1,7,17
6941,1971,53,Graduation,Single,31632,92,17,8,12,11,15,32,95,1,2,1,2,6
10972,1949,75,Graduation,Widow,72298,52,625,35,169,58,17,35,939,1,4,3,6,14
10708,1978,46,2n Cycle,Single,36975,50,10,6,11,0,4,2,33,1,1,0,3,5
6583,1955,69,2n Cycle,Married,72635,54,390,22,323,104,35,107,981,1,6,8,6,21
3641,1976,48,Graduation,Married,13624,93,10,2,15,2,1,6,36,2,2,0,3,7
10156,1975,49,Graduation,Single,84196,56,215,63,507,231,31,190,1237,1,8,4,7,20
4299,1960,64,Graduation,Together,70971,28,1001,17,572,93,125,17,1825,7,11,11,5,34
3469,1977,47,PhD,Divorced,34487,94,19,18,33,24,1,8,103,3,3,0,3,9
5063,1977,47,Graduation,Single,28769,76,41,5,129,10,3,3,191,3,4,1,4,12
10727,1970,54,PhD,Married,69084,43,1181,107,199,39,30,30,1586,2,7,3,13,25
9624,1958,66,PhD,Together,65488,46,603,45,207,36,18,54,963,1,3,4,6,14
5156,1970,54,2n Cycle,Married,62466,13,129,129,259,168,121,83,889,5,6,3,12,26
4376,1960,64,2n Cycle,Single,32218,27,10,24,15,13,1,30,93,1,2,1,3,7
8923,1973,51,Graduation,Single,83917,12,514,22,732,42,198,79,1587,1,6,7,7,21
8461,1962,62,Graduation,Divorced,46102,3,14,0,1,0,0,1,16,1,1,0,2,4
6945,1952,72,Graduation,Single,84574,72,387,20,713,38,54,163,1375,1,9,11,11,32
944,1962,62,Graduation,Married,56181,6,121,103,69,8,44,48,393,1,4,2,7,14
1907,1950,74,Master,Divorced,63120,53,965,69,279,54,41,69,1477,5,8,4,9,26
701,1971,53,Graduation,Married,73691,58,707,21,250,85,43,73,1179,2,6,2,8,18
3856,1960,64,Graduation,Together,63381,78,571,50,142,33,50,159,1005,4,4,5,13,26
4149,1948,76,PhD,Together,76140,57,586,66,653,17,0,26,1348,1,5,9,6,21
2131,1959,65,PhD,Divorced,62859,37,1063,89,102,16,12,25,1307,4,9,4,6,23
2942,1964,60,Graduation,Single,45906,20,305,3,27,4,3,144,486,2,5,4,4,15
1173,1947,77,Master,Together,77632,73,1200,105,758,0,42,147,2252,1,4,2,6,13
4381,1971,53,PhD,Married,46463,56,163,2,40,8,11,11,235,7,3,1,6,17
4611,1970,54,Graduation,Together,105471,36,1009,181,104,202,21,207,1724,0,9,8,13,30
3376,1970,54,Master,Divorced,55282,9,125,6,73,8,4,19,235,1,3,1,6,11
4679,1977,47,Master,Married,78710,42,721,0,152,119,50,50,1092,3,7,6,12,28
10928,1958,66,Graduation,Together,66886,28,315,4,62,41,31,146,599,2,7,1,7,17
4248,1960,64,Master,Single,98777,23,1000,19,711,125,115,38,2008,0,4,6,9,19
6728,1985,39,Graduation,Together,29103,38,16,0,17,6,3,6,48,2,1,0,3,6
6661,1974,50,Graduation,Married,67445,63,757,80,217,29,80,11,1174,5,9,6,12,32
4725,1950,74,PhD,Together,50616,71,30,2,25,0,1,9,67,1,1,1,4,7
3277,1955,69,Graduation,Divorced,49431,9,219,3,100,26,0,17,365,2,7,1,5,15
5555,1975,49,Graduation,Divorced,153924,81,1,1,1,1,1,1,6,0,0,0,0,0
2564,1953,71,Graduation,Together,61278,87,111,3,28,2,6,15,165,2,3,1,4,10
946,1958,66,2n Cycle,Together,26490,92,45,47,52,21,20,25,210,2,3,1,5,11
3867,1947,77,PhD,Together,73059,36,410,112,420,0,82,71,1095,1,9,3,13,26
6940,1966,58,PhD,Single,46734,86,100,1,39,6,1,76,223,4,3,2,3,12
55,1963,61,Graduation,Together,56253,83,509,0,65,7,11,5,597,4,7,2,9,22
7093,1985,39,Graduation,Married,19986,74,3,6,5,0,2,6,22,1,0,0,3,4
5084,1975,49,Graduation,Widow,58330,87,445,53,213,104,98,151,1064,1,6,4,13,24
1777,1980,44,Basic,Married,25965,29,2,2,11,41,7,11,74,1,2,0,3,6
8162,1956,68,Master,Together,14661,88,4,1,11,6,2,2,26,1,1,0,3,5
10826,1959,65,Graduation,Married,18690,77,6,1,7,23,4,19,60,1,1,1,2,5
8754,1974,50,PhD,Together,45068,25,14,0,3,0,0,3,20,1,1,0,2,4
1987,1987,37,Basic,Single,21063,34,1,10,11,19,3,15,59,2,2,0,3,7
11007,1968,56,PhD,Married,29187,43,26,0,6,0,0,2,34,1,1,0,3,5
7426,1971,53,2n Cycle,Married,54690,76,111,16,37,7,9,18,198,3,3,1,5,12
9153,1964,60,PhD,Married,59304,81,418,61,428,80,51,10,1048,3,7,8,10,28
10379,1962,62,Master,Single,59247,87,327,9,122,19,14,83,574,5,5,2,9,21
9204,1970,54,Graduation,Widow,66731,33,371,159,194,58,106,141,1029,4,4,3,6,17
3197,1980,44,Graduation,Married,77353,38,275,59,107,69,101,59,670,2,6,4,8,20
2920,1975,49,PhD,Single,52614,63,789,0,142,12,9,38,990,2,2,4,8,16
6961,1974,50,Graduation,Married,26751,26,1,1,5,0,3,1,11,1,1,0,2,4
4673,1963,61,PhD,Married,81300,17,1004,12,145,32,12,36,1241,3,10,3,5,21
9937,1979,45,Graduation,Single,70337,75,187,81,149,25,43,91,576,1,2,2,12,17
8779,1985,39,2n Cycle,Married,36145,13,56,4,76,17,1,18,172,4,4,1,3,12
9596,1980,44,PhD,Single,65295,19,365,32,117,34,110,6,664,1,3,3,13,20
2891,1963,61,Graduation,Divorced,68118,51,595,23,123,10,23,154,928,2,8,9,4,23
4910,1967,57,Graduation,Divorced,68743,81,1132,134,384,175,134,115,2074,1,11,5,13,30
75,1982,42,2n Cycle,Together,41039,32,34,11,137,179,61,45,467,1,8,1,5,15
10120,1955,69,Graduation,Together,38946,84,116,6,82,6,6,41,257,2,3,1,6,12
6327,1967,57,Graduation,Together,65777,87,565,32,435,28,32,54,1146,1,2,8,6,17
10142,1976,48,PhD,Divorced,66476,99,372,18,126,47,48,78,689,2,5,2,11,20
9826,1972,52,PhD,Single,86857,96,899,102,838,133,102,40,2114,1,5,6,10,22
1501,1982,42,PhD,Married,160803,21,55,16,1622,17,3,4,1717,15,0,28,1,44
10767,1989,35,PhD,Together,77845,40,760,40,480,0,40,26,1346,1,3,5,12,21
7279,1969,55,PhD,Together,69476,3,260,86,559,63,9,67,1044,1,4,6,4,15
7230,1960,64,PhD,Divorced,50611,98,459,0,24,6,0,4,493,6,4,5,7,22
143,1970,54,Graduation,Single,61209,73,466,0,224,119,49,99,957,1,5,3,4,13
450,1958,66,Master,Together,42315,90,67,15,80,17,11,80,270,3,1,4,4,12
9316,1952,72,Basic,Together,13084,29,2,0,7,3,7,10,29,1,1,0,3,5
6379,1949,75,Master,Widow,47570,3,67,1,20,0,2,31,121,3,2,2,2,9
9239,1961,63,Master,Married,61923,94,92,4,18,3,3,6,126,1,2,1,4,8
8315,1995,29,Graduation,Single,34824,65,4,2,11,2,0,4,23,1,1,0,2,4
2868,1949,75,PhD,Single,26518,33,20,1,28,3,3,2,57,3,2,0,3,8
10888,1961,63,Graduation,Single,45938,46,273,11,178,62,83,29,636,2,8,4,6,20
1277,1960,64,Graduation,Together,78468,29,434,22,388,104,22,34,1004,1,10,7,10,28
9977,1973,51,Graduation,Divorced,78901,99,321,11,309,33,26,34,734,3,9,3,5,20
10196,1978,46,Graduation,Married,71427,26,212,123,177,15,64,23,614,2,8,2,8,20
6384,1978,46,Graduation,Divorced,71022,30,909,12,278,0,12,242,1453,3,5,2,11,21
8029,1988,36,Master,Single,90247,27,1184,32,352,21,16,16,1621,1,3,4,7,15
968,1968,56,Master,Divorced,41335,24,112,19,21,16,14,5,187,3,4,1,4,12
6988,1986,38,Graduation,Married,71952,93,656,80,455,52,107,93,1443,2,8,4,8,22
4472,1970,54,PhD,Divorced,35682,34,23,0,8,6,2,18,57,1,1,1,3,6
6991,1951,73,Graduation,Divorced,43185,88,537,6,42,16,6,30,637,2,9,3,6,20
3336,1948,76,PhD,Together,66375,96,712,0,45,0,0,191,948,3,2,4,5,14
4301,1971,53,Master,Married,35178,10,23,1,13,2,2,18,59,1,1,1,2,5
1940,1986,38,Graduation,Married,25252,26,1,3,4,2,2,6,18,1,1,0,2,4
1272,1965,59,Master,Single,55250,49,664,58,83,32,0,66,903,4,7,5,10,26
1388,1975,49,Graduation,Single,33249,11,6,10,21,19,14,42,112,2,2,1,3,8
1044,1953,71,Graduation,Together,58398,44,299,5,201,21,21,49,596,3,5,4,8,20
6969,1982,42,Graduation,Together,50272,75,99,13,66,43,8,4,233,3,4,1,5,13
10479,1975,49,PhD,Married,76618,64,749,40,294,121,160,147,1511,1,3,2,5,11
3619,1960,64,2n Cycle,Divorced,87305,19,345,25,501,63,138,80,1152,1,5,3,8,17
1715,1978,46,Graduation,Together,25851,45,9,4,18,7,5,5,48,2,2,0,3,7
10159,1970,54,Graduation,Divorced,58710,77,440,81,368,0,122,174,1185,6,11,5,9,31
1463,1958,66,Graduation,Single,45160,9,8,2,5,3,0,3,21,1,1,0,2,4
5114,1965,59,Master,Married,74806,1,670,9,249,0,28,9,965,2,5,4,5,16
4990,1954,70,Graduation,Married,59111,90,524,0,134,28,28,155,869,1,11,1,8,21
4329,1984,40,PhD,Married,18988,43,6,0,6,2,1,1,16,2,1,0,3,6
10936,1965,59,Graduation,Married,72190,79,597,166,597,172,166,249,1947,1,5,6,4,16
4692,1976,48,Graduation,Married,7500,19,7,0,12,13,7,32,71,5,4,1,2,12
7212,1966,58,Graduation,Married,44794,99,54,0,7,0,0,4,65,1,2,0,3,6
6086,1955,69,Graduation,Married,80395,62,445,25,706,80,76,48,1380,1,6,5,12,24
437,1976,48,Master,Divorced,75012,41,294,142,218,164,58,151,1027,1,3,8,11,23
11171,1965,59,Master,Married,56962,60,292,3,77,10,3,26,411,7,6,3,5,21
11101,1991,33,Graduation,Together,89891,17,412,22,132,59,28,183,836,1,11,6,8,26
5329,1949,75,PhD,Divorced,35946,24,8,0,3,0,0,0,11,1,0,0,3,4
610,1953,71,PhD,Together,53593,60,349,4,78,6,0,43,480,8,7,2,6,23
9384,1978,46,Graduation,Married,66373,57,328,9,124,12,24,109,606,7,4,2,10,23
5956,1948,76,PhD,Divorced,45072,74,144,2,99,7,2,30,284,5,6,1,4,16
10430,1973,51,Graduation,Divorced,89694,22,1126,28,211,37,28,42,1472,3,4,3,4,14
7875,1949,75,Graduation,Married,72025,46,967,0,617,43,50,0,1677,1,4,8,13,26
7072,1973,51,Graduation,Married,67432,69,432,79,341,177,136,170,1335,2,8,5,4,19
6255,1952,72,Master,Together,70545,29,138,39,63,55,18,21,334,1,4,1,7,13
6516,1989,35,Basic,Married,17487,37,0,0,1,7,4,6,18,1,1,0,2,4
5564,1969,55,Graduation,Together,62882,26,509,133,497,78,24,97,1338,2,7,5,6,20
5682,1953,71,PhD,Single,64108,8,948,10,86,13,21,21,1099,4,6,9,11,30
7458,1956,68,Master,Together,34941,26,39,2,25,4,3,24,97,2,3,0,3,8
5237,1950,74,PhD,Single,48767,79,28,1,21,3,0,10,63,3,2,1,3,9
7761,1978,46,2n Cycle,Together,38702,71,13,11,24,13,8,40,109,2,3,0,4,9
5278,1964,60,Graduation,Married,82224,83,307,26,360,138,31,40,902,1,6,9,5,21
3560,1952,72,Graduation,Together,83844,57,901,31,345,75,31,191,1574,1,4,4,11,20
7235,1975,49,2n Cycle,Married,17003,37,2,5,12,4,8,7,38,3,2,0,4,9
10548,1995,29,Graduation,Single,71163,30,283,17,372,138,106,44,960,1,3,8,12,24
2281,1970,54,Graduation,Single,33697,34,4,3,7,0,3,11,28,1,1,0,2,4
4073,1954,70,2n Cycle,Married,63564,0,769,80,252,15,34,65,1215,1,10,10,7,28
6974,1972,52,PhD,Together,83443,89,518,42,742,55,56,84,1497,1,6,10,5,22
7938,1958,66,PhD,Together,51518,92,350,8,66,17,4,4,449,2,3,2,10,17
7094,1975,49,Graduation,Widow,58330,87,445,53,213,104,98,151,1064,1,6,4,13,24
3667,1969,55,Graduation,Married,80952,20,778,178,689,41,27,44,1757,1,8,5,11,25
7723,1979,45,Graduation,Together,75507,56,709,93,374,104,80,80,1440,1,8,6,6,21
3870,1978,46,2n Cycle,Together,63855,28,359,35,314,93,116,89,1006,1,7,3,13,24
4012,1972,52,PhD,Together,62220,55,799,12,375,16,12,12,1226,5,7,6,5,23
5909,1964,60,Graduation,Married,58512,25,895,10,101,13,0,152,1171,5,3,4,8,20
10470,1979,45,Master,Married,40662,0,40,2,23,0,4,23,92,2,2,1,3,8
6488,1959,65,PhD,Married,38829,86,76,0,7,0,0,16,99,1,3,2,2,8
10270,1981,43,2n Cycle,Married,35523,8,11,5,22,12,5,11,66,2,3,0,3,8
6887,1967,57,Graduation,Single,79146,33,245,16,223,21,43,16,564,2,8,1,8,19
6406,1988,36,Master,Married,78285,13,647,107,391,175,67,40,1427,1,6,4,10,21
7573,1978,46,PhD,Single,31626,12,39,1,9,2,1,34,86,1,2,1,2,6
4508,1952,72,Graduation,Single,75127,92,203,35,305,46,17,227,833,1,2,11,5,19
221,1955,69,Graduation,Married,48726,90,138,3,38,4,0,59,242,3,3,2,4,12
5331,1977,47,Graduation,Married,74985,8,587,51,898,247,0,86,1869,1,3,6,7,17
1911,1987,37,Graduation,Together,67430,6,595,97,291,127,133,121,1364,1,11,5,12,29
20,1965,59,2n Cycle,Married,46891,91,43,12,23,29,15,61,183,1,2,1,4,8
8786,1956,68,Master,Married,62058,52,301,7,74,10,0,58,450,4,6,1,7,18
10582,1979,45,Graduation,Married,72063,3,180,32,348,76,32,90,758,2,5,2,12,21
1915,1951,73,PhD,Married,78939,57,794,115,243,150,0,205,1507,1,8,5,6,20
8897,1965,59,Graduation,Single,42720,9,392,5,91,28,26,112,654,8,7,3,7,25
2371,1972,52,Graduation,Married,33622,22,39,1,22,3,4,12,81,3,2,0,4,9
4303,1957,67,PhD,Together,6835,76,107,2,12,2,2,12,137,0,0,0,1,1
6825,1953,71,Graduation,Together,41452,86,13,0,3,0,0,0,16,1,1,0,2,4
1072,1965,59,PhD,Single,40760,64,70,0,17,0,0,6,93,2,2,1,3,8
4964,1958,66,PhD,Together,74250,90,680,11,392,75,0,0,1158,1,2,11,4,18
2461,1955,69,Master,Single,51124,79,26,1,11,0,1,4,43,2,1,0,3,6
10736,1971,53,Graduation,Single,72258,28,522,0,522,227,120,134,1525,2,6,9,5,22
3194,1974,50,PhD,Single,71466,86,412,12,546,78,182,0,1230,1,4,4,10,19
10839,1976,48,Graduation,Together,36283,42,6,5,5,8,0,5,29,2,1,0,3,6
49,1970,54,Graduation,Single,20587,39,2,3,6,4,1,9,25,1,1,1,2,5
4290,1972,52,Graduation,Married,30467,8,1,3,8,2,5,5,24,1,1,0,2,4
10219,1972,52,Graduation,Together,31590,40,6,2,15,6,6,3,38,1,1,0,3,5
4211,1986,38,Basic,Married,20425,5,4,12,5,3,16,17,57,2,2,0,3,7
1135,1960,64,Master,Together,17144,96,18,2,19,0,2,6,47,5,3,0,4,12
6299,1968,56,PhD,Divorced,42564,28,324,48,186,39,18,198,813,6,6,8,4,24
10846,1978,46,Master,Married,43783,22,327,9,125,25,4,139,629,6,7,1,8,22
347,1976,48,Graduation,Divorced,40780,30,229,27,71,13,3,34,377,4,7,1,5,17
6543,1945,79,Master,Together,62847,45,521,168,706,80,76,61,1612,1,3,6,4,14
10446,1957,67,PhD,Married,82017,58,184,23,446,30,23,23,729,1,5,4,7,17
3479,1950,74,Graduation,Single,16813,49,4,8,11,12,2,13,50,1,2,0,3,6
11075,1978,46,Graduation,Married,51267,37,183,2,64,7,2,12,270,4,3,3,5,15
4442,1961,63,Graduation,Single,46524,70,31,19,35,26,14,52,177,2,1,1,5,9
199,1962,62,Master,Single,45183,33,219,3,60,12,9,12,315,1,4,1,7,13
6722,1954,70,PhD,Married,70421,98,479,28,136,75,14,35,767,3,10,3,7,23
796,1965,59,2n Cycle,Divorced,60161,17,584,44,212,46,8,177,1071,3,11,4,8,26
3749,1973,51,Graduation,Together,73926,54,627,91,597,159,91,15,1580,1,6,5,12,24
8523,1968,56,Graduation,Married,19329,39,24,1,16,12,2,5,60,3,4,0,3,10
310,1970,54,Master,Married,61872,81,330,5,159,36,27,16,573,4,4,4,9,21
8629,1956,68,Graduation,Widow,46984,71,19,1,10,2,1,8,41,1,1,0,3,5
236,1951,73,Graduation,Married,34838,62,28,23,29,29,14,47,170,3,2,1,4,10
9930,1944,80,PhD,Single,82716,8,606,148,228,15,148,22,1167,1,6,8,13,28
3483,1958,66,Graduation,Married,48192,76,1039,43,204,153,58,29,1526,3,2,8,12,25
4599,1976,48,Master,Married,49681,66,411,0,26,0,0,21,458,6,7,1,7,21
7326,1971,53,Master,Married,56850,83,34,1,19,2,7,0,63,1,1,1,3,6
7352,1957,67,Graduation,Married,55267,28,161,28,136,32,3,45,405,4,3,4,6,17
2350,1972,52,Graduation,Married,59666,87,623,53,178,23,17,133,1027,7,3,2,8,20
9145,1972,52,Graduation,Single,72504,43,604,26,470,123,161,94,1478,2,5,9,6,22
2964,1981,43,Graduation,Married,26872,0,3,10,8,3,16,32,72,1,1,1,2,5
5585,1972,52,Graduation,Single,21359,1,12,2,17,6,1,10,48,2,2,0,3,7
9687,1975,49,Graduation,Single,73170,1,184,174,256,50,30,32,726,1,5,4,6,16
3732,1955,69,Master,Married,52750,72,393,0,239,90,69,69,860,6,5,7,9,27
6303,1986,38,PhD,Together,91820,72,410,73,747,76,161,30,1497,0,5,5,12,22
11176,1970,54,PhD,Together,65968,12,376,9,83,19,4,4,495,2,5,4,7,18
2986,1976,48,Graduation,Married,30772,89,7,2,4,2,1,4,20,1,1,0,2,4
7462,1954,70,Graduation,Single,22507,67,68,0,226,51,157,68,570,3,10,2,4,19
3900,1972,52,Graduation,Married,65685,54,642,14,49,0,7,57,769,1,9,2,9,21
7034,1978,46,2n Cycle,Married,25804,34,8,7,9,13,6,12,55,2,2,0,3,7
9493,1980,44,PhD,Single,76412,15,840,53,804,23,71,17,1808,1,5,4,8,18
1143,1972,52,Graduation,Married,22063,43,7,10,13,3,11,11,55,2,2,0,3,7
1,1961,63,Graduation,Single,57091,0,464,5,64,7,0,37,577,1,7,3,7,18
3855,1963,61,Graduation,Married,22419,74,30,3,47,19,21,42,162,1,3,2,2,8
5536,1959,65,Graduation,Together,87771,61,1492,38,287,50,57,33,1957,1,5,10,4,20
5989,1959,65,2n Cycle,Divorced,78353,51,752,122,476,39,153,34,1576,1,10,2,11,24
9499,1954,70,Graduation,Married,93404,97,1279,15,287,20,0,15,1616,3,3,4,7,17
6768,1962,62,Graduation,Divorced,37859,75,22,1,8,2,1,2,36,2,1,0,3,6
2150,1958,66,PhD,Widow,80995,83,860,28,409,73,56,56,1482,1,8,9,4,22
6646,1984,40,Graduation,Together,16529,23,3,0,5,13,0,1,22,1,1,0,3,5
4887,1976,48,PhD,Divorced,55412,65,10,5,28,11,1,8,63,1,2,0,3,6
8560,1992,32,Graduation,Single,48789,94,351,16,156,7,5,145,680,1,6,4,7,18
3321,1967,57,PhD,Together,56575,42,421,5,90,0,16,10,542,3,7,3,7,20
11003,1980,44,2n Cycle,Together,25130,10,2,5,7,0,18,18,50,2,2,0,3,7
10402,1967,57,Graduation,Married,35441,94,25,1,9,2,1,1,39,2,1,0,3,6
9904,1956,68,Graduation,Married,71391,50,336,123,274,46,123,141,1043,5,6,5,12,28
6141,1972,52,Master,Single,49494,46,191,9,97,0,6,82,385,2,6,1,5,14
5687,1980,44,Graduation,Divorced,81702,98,563,50,774,28,31,187,1633,1,7,7,12,27
10856,1980,44,2n Cycle,Single,45889,42,31,0,6,0,1,8,46,1,1,0,3,5
5121,1977,47,Graduation,Single,56628,30,479,5,82,7,17,171,761,2,7,6,5,20
4186,1950,74,Graduation,Together,34026,11,18,6,15,12,8,17,76,3,2,1,3,9
368,1974,50,Graduation,Married,40049,61,91,65,52,10,44,28,290,3,3,2,6,14
3312,1988,36,Graduation,Single,34176,12,5,7,24,19,14,20,89,4,3,0,4,11
11121,1981,43,Graduation,Married,19419,76,2,14,28,16,3,7,70,4,4,0,3,11
5332,1960,64,2n Cycle,Married,82504,2,362,50,431,134,35,54,1066,1,3,6,7,17
5848,1970,54,Graduation,Together,81205,43,724,74,929,97,55,130,2009,1,5,6,7,19
10343,1991,33,2n Cycle,Single,61618,27,605,91,399,0,45,205,1345,2,3,6,8,19
5935,1956,68,Master,Single,55284,60,547,7,140,0,7,63,764,3,7,5,8,23
2895,1963,61,Graduation,Single,49980,79,104,1,54,13,9,14,195,2,3,1,5,11
10262,1980,44,Graduation,Married,15072,96,8,2,15,0,10,18,53,4,3,1,3,11
7848,1974,50,Graduation,Single,49166,17,224,2,25,7,0,110,368,2,5,3,3,13
9477,1954,70,PhD,Married,65324,0,384,0,102,21,32,5,544,3,6,2,9,20
4856,1957,67,2n Cycle,Married,82347,38,556,54,845,202,133,63,1853,1,7,7,10,25
7186,1966,58,PhD,Together,30843,43,24,0,2,0,0,9,35,2,1,1,2,6
5794,1974,50,PhD,Married,46374,1,408,0,21,0,0,17,446,3,7,1,7,18
1456,1979,45,Graduation,Single,60474,25,265,199,303,234,9,170,1180,7,10,2,12,31
4877,1973,51,Master,Married,38576,2,34,0,7,0,0,0,41,1,1,0,3,5
425,1985,39,Graduation,Married,55357,66,374,64,116,84,25,64,727,3,6,2,11,22
3007,1966,58,Graduation,Together,37758,49,27,2,10,0,0,1,40,2,1,0,3,6
1031,1989,35,2n Cycle,Married,85710,5,600,20,350,29,30,33,1062,1,6,9,10,26
4297,1969,55,Graduation,Together,23228,71,13,2,18,6,1,0,40,2,2,0,3,7
807,1969,55,Master,Together,44602,35,167,2,89,0,0,34,292,6,6,1,4,17
9553,1987,37,Graduation,Married,7500,94,0,2,3,4,1,5,15,1,0,0,3,4
4271,1989,35,2n Cycle,Together,38683,80,46,35,69,84,41,66,341,6,4,1,6,17
4120,1975,49,2n Cycle,Single,49514,61,88,39,78,58,13,93,369,2,6,1,4,13
2036,1973,51,PhD,Together,57906,29,243,11,119,10,3,15,401,3,4,2,8,17
115,1966,58,Master,Single,43456,0,275,11,68,25,7,7,393,3,5,1,8,17
4259,1986,38,Master,Single,19485,80,6,0,4,0,0,0,10,1,1,0,2,4
8687,1978,46,Graduation,Together,53172,54,121,62,90,68,20,125,486,3,2,3,8,16
2447,1979,45,Graduation,Together,30545,71,4,12,15,19,7,12,69,2,2,0,3,7
10140,1983,41,PhD,Together,70123,27,1308,0,396,23,0,0,1727,1,5,7,4,17
9353,1959,65,Graduation,Single,62450,61,515,47,267,62,66,38,995,2,5,5,4,16
3623,1976,48,Graduation,Together,21675,55,4,0,16,17,4,4,45,3,4,0,3,10
738,1981,43,2n Cycle,Single,42395,35,48,13,57,24,15,25,182,4,3,1,4,12
7631,1978,46,Master,Together,61346,34,562,58,168,43,16,142,989,1,5,7,10,23
4789,1953,71,Graduation,Together,80812,95,769,22,500,210,143,33,1677,1,4,8,5,18
773,1971,53,Master,Divorced,42835,64,379,4,93,12,9,98,595,7,6,6,4,23
10602,1983,41,Graduation,Married,39922,30,29,12,59,19,1,36,156,2,3,0,4,9
1446,1956,68,Master,Single,86424,12,387,68,569,89,45,68,1226,1,6,9,12,28
3270,1978,46,2n Cycle,Together,17117,96,12,23,38,30,18,7,128,4,3,1,3,11
8443,1972,52,Graduation,Single,24762,16,6,10,12,3,15,40,86,3,3,1,2,9
9653,1975,49,Graduation,Married,35797,16,27,1,14,4,1,21,68,2,2,0,3,7
8916,1975,49,Graduation,Divorced,36627,78,9,1,5,0,0,1,16,1,0,0,3,4
8017,1981,43,2n Cycle,Married,51111,83,22,0,19,6,5,3,55,2,2,0,3,7
5830,1972,52,PhD,Single,86857,96,899,102,838,133,102,40,2114,1,5,6,10,22
4597,1970,54,PhD,Together,82072,67,889,55,685,168,92,129,2018,1,3,2,13,19
7023,1953,71,PhD,Single,46231,87,189,2,55,0,5,12,263,4,6,1,4,15
8086,1959,65,Graduation,Married,42243,34,48,0,2,0,0,5,55,2,2,0,3,7
8825,1962,62,Graduation,Together,51195,46,230,14,156,82,24,58,564,8,9,2,5,24
2930,1978,46,Master,Single,68092,7,852,60,207,78,36,48,1281,2,2,6,10,20
1928,1973,51,Graduation,Married,31814,73,35,3,20,4,1,20,83,2,2,0,3,7
7108,1965,59,Master,Widow,51390,54,205,20,47,23,2,56,353,6,5,2,5,18
10925,1983,41,Graduation,Married,76630,93,255,31,446,40,56,175,1003,1,3,10,11,25
9960,1991,33,Basic,Single,26868,52,0,0,1,8,3,2,14,1,1,0,2,4
8800,1943,81,PhD,Divorced,48948,53,437,8,206,160,49,42,902,2,7,10,5,24
9224,1972,52,PhD,Single,55260,81,825,8,53,11,0,242,1139,2,8,10,5,25
5519,1956,68,Graduation,Together,64090,8,316,58,161,76,51,135,797,1,6,9,4,20
5046,1958,66,Graduation,Divorced,78331,97,756,138,354,160,169,61,1638,2,10,6,7,25
7037,1974,50,PhD,Married,37087,50,194,55,134,15,0,3,401,3,4,2,8,17
905,1986,38,Graduation,Divorced,21846,38,7,17,18,6,10,26,84,4,4,0,3,11
8624,1958,66,Graduation,Married,81320,61,183,33,493,59,103,57,928,1,4,3,10,18
8945,1970,54,Graduation,Divorced,54137,46,171,0,11,0,1,20,203,2,4,1,4,11
6445,1967,57,Graduation,Together,66825,73,243,101,405,29,40,40,858,1,4,5,6,16
2727,1973,51,Graduation,Together,57100,19,181,21,69,39,3,96,409,1,3,3,6,13
6404,1969,55,Graduation,Together,58917,10,151,7,89,0,7,28,282,5,4,1,6,16
11074,1977,47,Graduation,Single,85072,94,494,92,391,194,11,241,1423,1,3,4,10,18
10150,1961,63,Graduation,Single,86429,10,464,28,873,29,18,37,1449,0,7,4,7,18
1968,1971,53,Graduation,Widow,45684,37,5,1,5,10,0,7,28,1,1,0,2,4
6534,1974,50,Graduation,Together,47889,94,29,0,29,0,5,4,67,1,2,0,3,6
9485,1986,38,PhD,Married,45921,23,102,9,49,24,3,12,199,1,2,1,6,10
7053,1966,58,PhD,Single,78420,75,604,28,674,91,28,28,1453,1,3,10,8,22
4654,1992,32,Graduation,Together,75114,40,571,12,523,63,60,24,1253,1,3,10,5,19
9760,1963,61,PhD,Widow,52278,24,953,0,71,0,0,174,1198,6,10,5,10,31
1048,1972,52,Master,Married,35641,11,63,3,67,8,9,28,178,2,3,1,4,10
10619,1994,30,Graduation,Single,95529,29,770,29,890,250,27,24,1990,1,7,3,7,18
9308,1954,70,Graduation,Married,62820,51,398,61,265,138,61,53,976,1,3,4,6,14
10505,1960,64,Master,Together,73113,86,741,19,154,50,9,28,1001,1,3,4,7,15
8362,1982,42,PhD,Married,84169,9,1478,19,403,0,19,0,1919,1,7,6,6,20
2625,1954,70,2n Cycle,Single,42607,30,156,29,56,30,32,47,350,2,3,2,7,14
4637,1954,70,PhD,Single,74637,73,960,64,464,146,0,16,1650,1,6,9,9,25
9972,1955,69,PhD,Together,46015,25,38,0,2,0,0,6,46,1,1,0,3,5
4483,1993,31,Graduation,Single,72354,67,315,26,473,220,12,182,1228,1,2,10,6,19
4487,1969,55,Master,Single,39858,67,15,20,25,2,7,26,95,1,2,0,4,7
4988,1948,76,PhD,Married,34469,58,19,6,20,0,5,12,62,3,1,1,4,9
8931,1986,38,Graduation,Together,83033,82,812,99,431,237,149,33,1761,1,11,4,10,26
5871,1979,45,Master,Together,24401,98,73,28,217,10,24,115,467,3,6,1,6,16
2008,1978,46,Graduation,Married,77583,93,372,23,384,250,12,108,1149,1,4,5,9,19
3139,1982,42,2n Cycle,Single,74116,53,871,111,704,145,55,166,2052,1,4,4,10,19
10037,1993,31,Graduation,Single,74293,66,375,152,335,93,91,81,1127,1,5,4,6,16
10673,1976,48,PhD,Married,68397,6,760,80,466,17,13,80,1416,1,6,9,5,21
5303,1974,50,PhD,Together,79632,42,471,0,510,99,21,12,1113,1,6,4,9,20
538,1989,35,Graduation,Single,46107,78,31,9,27,16,9,33,125,1,1,1,4,7
7922,1951,73,PhD,Single,64950,29,819,0,72,12,0,63,966,2,11,2,10,25
5692,1989,35,Basic,Married,25443,82,1,4,3,8,9,7,32,1,1,0,3,5
4843,1952,72,Graduation,Single,75127,92,203,35,305,46,17,227,833,1,2,11,5,19
6383,1971,53,PhD,Together,32892,78,26,0,15,2,1,2,46,2,3,0,3,8
1628,1971,53,Graduation,Together,71796,54,354,21,311,167,75,32,960,1,9,3,4,17
1204,1970,54,PhD,Married,67536,45,1253,0,447,23,71,35,1829,3,11,5,11,30
3673,1971,53,Graduation,Single,55239,59,371,17,238,23,24,106,779,3,7,5,11,26
760,1975,49,PhD,Divorced,60554,8,588,7,76,110,15,15,811,2,8,4,9,23
8957,1952,72,2n Cycle,Single,64831,51,480,86,249,75,86,144,1120,8,6,3,5,22
4128,1962,62,PhD,Together,56067,51,517,12,54,16,6,120,725,2,7,4,7,20
6810,1983,41,Graduation,Divorced,82025,76,267,98,606,48,70,98,1187,1,3,2,6,12
5386,1953,71,Graduation,Together,94384,62,1111,24,790,160,45,172,2302,0,5,8,5,18
8700,1986,38,Basic,Single,14906,86,7,7,14,7,16,15,66,3,2,1,3,9
3202,1987,37,PhD,Married,51563,60,1166,0,48,0,0,36,1250,1,4,4,10,19
1328,1982,42,2n Cycle,Married,57937,56,261,42,144,55,48,133,683,3,4,4,9,20
8405,1979,45,Graduation,Divorced,68274,83,135,25,51,23,25,46,305,2,4,2,5,13
6515,1977,47,Graduation,Together,39771,92,6,2,18,2,8,14,50,1,2,0,3,6
2882,1975,49,2n Cycle,Divorced,67893,31,711,28,142,49,18,47,995,2,3,2,9,16
7574,1979,45,PhD,Together,27922,80,11,0,13,2,4,11,41,1,2,0,3,6
6387,1976,48,PhD,Together,52190,39,42,0,17,0,0,18,77,3,2,1,3,9
5320,1973,51,Master,Divorced,44051,20,79,7,58,6,3,18,171,4,3,1,4,12
5048,1971,53,PhD,Single,42767,53,20,6,43,19,5,38,131,1,3,1,2,7
8146,1976,48,Master,Together,46106,84,30,0,8,2,0,14,54,1,1,1,2,5
10031,1976,48,PhD,Married,16927,50,20,2,23,3,1,4,53,5,3,0,4,12
5748,1965,59,Graduation,Married,59754,96,115,27,44,4,146,139,475,3,5,2,6,16
2134,1952,72,Graduation,Single,53700,94,263,5,233,69,41,83,694,4,5,5,8,22
1523,1973,51,Graduation,Married,59041,25,69,2,15,2,2,6,96,2,2,0,4,8
9665,1957,67,PhD,Divorced,54237,48,267,3,30,4,0,57,361,4,5,2,5,16
4640,1967,57,Graduation,Divorced,70647,65,561,85,171,25,123,114,1079,2,4,7,13,26
3635,1962,62,PhD,Single,52597,69,492,0,37,7,0,42,578,3,6,3,8,20
3547,1969,55,Master,Together,41021,12,14,7,9,6,16,12,64,2,2,0,3,7
2456,1975,49,PhD,Married,40233,84,80,4,46,0,17,2,149,5,2,1,5,13
5633,1980,44,Graduation,Married,50183,47,97,12,84,13,10,15,231,7,3,1,6,17
7801,1959,65,Graduation,Together,54753,87,197,107,227,7,59,131,728,3,5,2,11,21
10489,1973,51,Graduation,Married,92955,35,693,21,925,31,24,84,1778,1,6,7,9,23
7011,1973,51,Graduation,Married,33471,47,43,2,27,0,9,12,93,3,3,0,4,10
2620,1974,50,PhD,Married,34596,48,14,0,2,0,0,7,23,1,1,0,2,4
3933,1980,44,Graduation,Together,44010,46,186,36,234,86,72,48,662,6,10,2,6,24
10981,1988,36,Graduation,Married,84219,27,434,137,400,45,137,45,1198,1,3,4,10,18
1734,1968,56,PhD,Together,40706,37,59,0,11,4,2,5,81,4,3,0,4,11
10995,1988,36,2n Cycle,Married,15716,8,16,5,30,8,7,26,92,3,3,0,4,10
6357,1959,65,2n Cycle,Divorced,59052,29,230,35,75,63,57,31,491,3,7,1,7,18
9209,1971,53,Master,Together,80573,85,829,138,430,60,92,15,1564,1,4,6,13,24
10286,1962,62,Graduation,Married,83715,2,318,8,407,150,35,8,926,1,2,8,13,24
2611,1959,65,Master,Together,82576,66,1206,55,445,168,18,18,1910,1,2,4,12,19
1600,1965,59,Master,Married,56962,60,292,3,77,10,3,26,411,7,6,3,5,21
3308,1952,72,Graduation,Married,35704,54,30,9,12,2,11,30,94,3,2,0,4,9
5407,1954,70,Graduation,Together,53103,70,729,17,133,11,0,195,1085,5,10,6,7,28
2166,1960,64,2n Cycle,Widow,46779,55,12,1,3,0,0,7,23,1,0,1,2,4
3955,1965,59,Graduation,Divorced,4861,20,2,1,1,1,0,1,6,0,0,0,0,0
6634,1979,45,Master,Divorced,33462,78,22,3,18,0,0,11,54,1,2,0,3,6
3056,1978,46,Graduation,Divorced,63693,63,587,43,337,42,87,54,1150,3,11,6,9,29
5718,1950,74,Graduation,Married,80763,17,674,168,108,192,42,231,1415,1,5,11,6,23
6872,1974,50,PhD,Married,65352,43,284,3,84,4,7,23,405,2,4,2,8,16
8164,1978,46,PhD,Married,82170,13,1023,93,651,49,55,37,1908,1,5,6,7,19
4580,1969,55,Graduation,Married,75759,46,1394,22,708,89,91,182,2486,1,9,7,9,26
9305,1976,48,2n Cycle,Single,79689,65,311,26,640,180,37,121,1315,1,4,9,13,27
453,1956,68,PhD,Widow,35340,1,27,0,12,0,1,5,45,2,2,0,3,7
8545,1954,70,Graduation,Divorced,85683,6,1296,17,311,45,69,51,1789,1,2,4,10,17
9850,1972,52,2n Cycle,Married,24884,32,3,6,7,0,0,3,19,1,0,0,3,4
7378,1981,43,Master,Together,42021,34,393,5,136,7,5,27,573,5,10,1,6,22
7646,1989,35,Graduation,Single,64449,70,218,63,282,137,35,70,805,4,5,3,12,24
1640,1954,70,Graduation,Divorced,64587,49,66,0,16,0,6,20,108,2,1,1,4,8
5184,1995,29,Graduation,Single,34824,65,4,2,11,2,0,4,23,1,1,0,2,4
8492,1978,46,Graduation,Together,75437,25,795,0,545,95,58,0,1493,1,8,4,10,23
11188,1957,67,Graduation,Together,26091,84,15,10,19,8,17,20,89,3,2,1,3,9
1212,1973,51,Graduation,Married,52845,7,384,25,292,130,41,64,936,3,8,8,6,25
9097,1956,68,Graduation,Divorced,46086,34,244,8,32,7,2,50,343,4,3,1,8,16
10473,1956,68,PhD,Widow,78028,38,158,19,288,25,0,38,528,1,6,4,9,20
7962,1987,37,PhD,Single,95169,1,1285,21,449,106,20,20,1901,1,4,3,4,12
9984,1981,43,2n Cycle,Married,56337,25,349,16,144,28,5,182,724,5,8,5,4,22
5527,1987,37,Graduation,Together,22434,25,4,12,11,3,13,15,58,2,2,0,3,7
6374,1954,70,PhD,Married,36930,50,223,2,31,0,2,39,297,5,5,2,4,16
7453,1954,70,Graduation,Single,36130,46,157,43,127,68,56,37,488,6,3,8,4,21
8952,1953,71,Master,Married,65569,96,397,46,288,20,38,70,859,2,6,5,10,23
241,1952,72,Graduation,Together,83844,57,901,31,345,75,31,191,1574,1,4,4,11,20
8975,1968,56,Graduation,Married,19514,47,14,3,21,2,1,28,69,4,3,1,2,10
6119,1963,61,PhD,Single,36736,52,10,0,3,0,0,4,17,1,1,0,2,4
5236,1979,45,Graduation,Together,77568,30,1230,0,396,232,178,158,2194,1,10,2,8,21
5723,1976,48,PhD,Together,49187,63,81,1,31,2,1,0,116,1,1,1,5,8
1710,1978,46,Graduation,Single,30168,51,154,20,66,0,12,27,279,7,6,1,4,18
1970,1968,56,Master,Together,34053,14,63,0,21,7,0,12,103,1,3,0,3,7
5313,1971,53,Master,Married,38196,20,30,0,11,0,0,3,44,3,2,0,4,9
10634,1951,73,Master,Married,59412,56,90,67,165,30,43,11,406,1,4,2,8,15
7010,1965,59,2n Cycle,Married,70924,41,635,114,254,132,152,76,1363,1,6,6,7,20
8562,1969,55,Graduation,Together,54165,72,127,4,73,15,6,11,236,1,2,1,7,11
3158,1973,51,Graduation,Married,32300,1,13,3,6,6,5,6,39,1,1,0,3,5
4436,1976,48,Graduation,Single,20180,27,18,42,24,15,20,18,137,1,2,1,4,8
5287,1973,51,Graduation,Married,34961,77,45,2,26,4,1,1,79,3,3,1,3,10
2445,1974,50,PhD,Together,28440,87,38,1,24,0,0,0,63,1,2,0,3,6
6059,1953,71,PhD,Together,64504,81,986,36,168,16,0,108,1314,7,11,3,4,25
4550,1966,58,Master,Together,33564,51,61,0,3,0,0,7,71,1,1,1,3,6
4240,1978,46,Graduation,Married,17345,79,4,9,16,17,0,12,58,2,2,1,2,7
8911,1967,57,PhD,Married,56320,11,201,53,172,116,77,83,702,3,5,4,9,21
3706,1978,46,Graduation,Single,28647,54,19,8,29,0,12,26,94,1,2,2,2,7
3628,1987,37,Basic,Single,15038,93,4,8,11,19,12,26,80,2,2,1,2,7
10175,1958,66,PhD,Divorced,32173,0,18,0,2,0,0,2,22,1,1,0,3,5
8985,1964,60,2n Cycle,Together,68316,54,806,80,161,120,11,33,1211,5,10,7,10,32
5204,1971,53,Graduation,Together,74538,21,380,98,733,110,112,28,1461,1,8,8,5,22
9220,1971,53,Graduation,Single,91700,58,576,172,961,125,115,19,1968,1,8,6,5,20
9888,1969,55,Graduation,Together,68695,3,458,81,356,106,50,40,1091,1,4,4,7,16
5263,1977,47,2n Cycle,Married,31056,99,5,10,13,3,8,16,55,1,1,0,3,5
1020,1973,51,Graduation,Married,79593,70,350,60,568,110,133,145,1366,1,5,6,7,19
9503,1980,44,Graduation,Single,28071,65,39,33,130,41,26,44,313,2,5,1,5,13
10613,1958,66,PhD,Together,37334,44,26,1,16,2,2,15,62,4,3,0,4,11
67,1972,52,Master,Single,46423,6,68,0,16,0,0,8,92,3,2,0,4,9
6019,1971,53,PhD,Married,37126,9,45,3,9,4,4,7,72,1,1,2,2,6
5863,1953,71,Graduation,Married,47703,95,359,0,134,13,26,123,655,4,6,3,8,21
3717,1959,65,Graduation,Married,61180,70,403,24,29,6,24,218,704,2,5,5,6,18
6730,1954,70,Graduation,Married,38998,92,34,1,14,0,0,5,54,3,2,0,3,8
10749,1991,33,Graduation,Single,8028,62,73,18,66,7,12,2,178,15,0,1,0,16
4998,1962,62,Graduation,Together,76081,85,292,30,415,63,33,200,1033,1,4,5,4,14
6287,1986,38,Graduation,Together,34728,2,14,0,16,0,0,6,36,1,1,1,2,5
5985,1965,59,Master,Single,33168,0,80,1,37,0,1,3,122,3,2,1,4,10
4754,1966,58,Master,Married,33585,91,30,11,33,13,6,29,122,1,2,0,4,7
4002,1960,64,PhD,Married,77037,3,463,96,333,168,53,10,1123,1,7,7,12,27
8870,1984,40,Graduation,Together,35196,68,75,12,141,43,39,187,497,6,6,1,5,18
966,1966,58,Graduation,Married,44529,98,538,13,91,17,6,26,691,6,6,2,11,25
4767,1965,59,2n Cycle,Married,70924,41,635,114,254,132,152,76,1363,1,6,6,7,20
9725,1966,58,PhD,Together,28764,16,8,0,3,0,0,1,12,1,1,0,2,4
4475,1949,75,PhD,Married,69098,82,1315,22,780,145,0,178,2440,1,7,8,9,25
5740,1970,54,2n Cycle,Divorced,25959,1,4,2,12,7,5,26,56,2,1,2,2,7
5731,1983,41,Master,Married,27100,64,12,0,13,2,0,10,37,1,1,0,3,5
7290,1985,39,Graduation,Single,70596,68,347,44,534,17,0,26,968,1,3,5,12,21
3846,1974,50,Graduation,Married,42557,98,192,5,53,0,5,15,270,4,6,1,4,15
8104,1951,73,PhD,Married,53312,32,241,0,12,0,0,25,278,1,5,1,5,12
4507,1952,72,Graduation,Single,72228,87,631,28,491,30,14,56,1250,1,6,7,8,22
11013,1987,37,Graduation,Together,67605,84,336,28,282,184,54,54,938,1,2,8,6,17
4491,1949,75,Master,Married,62845,3,1099,0,45,0,0,34,1178,11,3,4,10,28
3759,1958,66,Graduation,Together,65196,34,743,19,181,12,0,200,1155,2,7,6,11,26
1162,1987,37,PhD,Single,42000,23,124,83,267,85,59,35,653,2,5,2,11,20
2055,1973,51,PhD,Divorced,35860,37,15,0,8,4,2,20,49,2,1,1,2,6
10766,1964,60,PhD,Married,65526,22,397,19,69,12,0,9,506,1,4,4,8,17
4415,1961,63,Graduation,Married,16860,19,10,4,4,3,3,14,38,3,1,1,3,8
3005,1992,32,Graduation,Single,83528,7,530,117,678,134,44,147,1650,1,4,10,8,23
2223,1965,59,2n Cycle,Divorced,64176,52,1215,33,249,64,116,149,1826,8,8,9,8,33
4817,1956,68,Graduation,Divorced,22304,91,3,2,7,0,4,2,18,1,1,0,2,4
2875,1978,46,Graduation,Married,67023,93,444,44,382,11,8,17,906,1,3,7,13,24
10536,1971,53,PhD,Together,32892,78,26,0,15,2,1,2,46,2,3,0,3,8
11112,1966,58,Graduation,Together,70713,23,736,114,279,82,76,190,1477,6,5,6,8,25
3807,1955,69,Graduation,Together,59925,83,473,21,176,19,21,56,766,3,9,2,9,23
9197,1953,71,Graduation,Married,39722,92,32,0,5,2,0,8,47,2,2,0,3,7
10832,1958,66,Graduation,Together,46610,4,288,10,30,4,10,125,467,1,6,1,6,14
6421,1961,63,Graduation,Together,88347,32,1050,178,555,77,138,118,2116,1,4,7,9,21
4207,1981,43,PhD,Married,87171,27,1001,44,107,58,44,44,1298,1,6,7,11,25
577,1976,48,2n Cycle,Together,26907,10,9,1,7,0,3,2,22,2,1,0,3,6
10855,1968,56,Master,Single,50014,9,234,14,77,19,10,42,396,2,4,1,8,15
3081,1978,46,PhD,Married,41014,65,7,2,6,2,0,3,20,1,1,0,2,4
3535,1965,59,Graduation,Single,66294,68,251,108,334,65,92,117,967,1,4,3,5,13
247,1971,53,Graduation,Married,36715,16,172,10,125,21,13,16,357,6,7,2,4,19
8707,1956,68,Graduation,Married,79456,12,565,42,548,64,83,99,1401,1,5,6,4,16
9523,1982,42,Graduation,Together,40479,95,5,0,8,2,0,0,15,1,0,0,3,4
6072,1970,54,Master,Single,75345,16,918,57,842,99,38,133,2087,1,5,8,6,20
6295,1977,47,Graduation,Married,54233,46,652,8,158,21,0,142,981,4,11,6,5,26
10914,1970,54,Graduation,Single,24163,3,4,1,7,2,1,2,17,2,1,0,3,6
1509,1958,66,PhD,Together,84460,80,152,27,103,106,54,81,523,0,9,9,4,22
5577,1983,41,Graduation,Together,43776,77,8,0,9,2,1,3,23,1,1,0,2,4
7348,1958,66,PhD,Single,71691,0,336,130,411,240,32,43,1192,1,4,7,5,17
1127,1973,51,PhD,Married,85844,62,938,19,843,25,95,38,1958,1,6,6,7,20
1833,1974,50,PhD,Single,39190,91,68,8,18,19,8,12,133,2,2,1,4,9
4944,1959,65,Graduation,Together,71367,24,227,23,389,42,21,75,777,1,4,5,7,17
9080,1972,52,PhD,Single,38578,2,38,4,22,3,3,3,73,3,3,0,3,9
6466,1965,59,PhD,Married,57236,22,105,0,9,2,1,4,121,3,2,1,4,10
9964,1979,45,Graduation,Single,61825,56,162,50,100,55,30,27,424,1,4,2,8,15
4790,1958,66,Graduation,Divorced,79803,54,574,8,216,21,16,33,868,1,4,3,5,13
10245,1986,38,2n Cycle,Single,80910,71,160,80,369,67,39,41,756,1,3,3,8,15
1109,1982,42,Master,Together,27590,38,6,0,5,0,0,1,12,1,1,0,2,4
6001,1979,45,Graduation,Married,56775,62,614,35,160,58,35,35,937,2,5,8,10,25
5538,1975,49,Graduation,Divorced,83829,78,897,161,430,186,161,27,1862,0,4,7,6,17
10552,1979,45,2n Cycle,Married,54210,18,70,54,109,80,9,45,367,2,4,1,7,14
1545,1986,38,Graduation,Married,38508,95,120,19,206,25,19,54,443,6,7,2,5,20
7409,1970,54,Graduation,Together,53187,66,211,2,30,7,7,10,267,2,4,1,6,13
4444,1972,52,Graduation,Married,30023,28,11,0,16,7,6,21,61,1,2,0,3,6
146,1960,64,PhD,Single,76045,78,760,53,400,17,93,0,1323,1,4,5,11,21
6271,1952,72,PhD,Married,50870,13,53,0,8,0,0,2,63,1,2,0,3,6
10065,1970,54,2n Cycle,Married,15315,27,7,4,13,15,8,17,64,2,2,0,4,8
4741,1974,50,2n Cycle,Married,65463,17,391,32,70,21,32,16,562,2,6,2,9,19
246,1965,59,Graduation,Married,66480,71,199,9,57,20,21,6,312,7,4,1,7,19
375,1954,70,Graduation,Divorced,76773,79,516,56,449,86,33,16,1156,1,2,2,11,16
1524,1983,41,2n Cycle,Single,81698,1,709,45,115,30,160,45,1104,1,8,2,5,16
10022,1973,51,PhD,Single,54466,78,12,0,4,0,0,0,16,1,1,0,2,4
7451,1960,64,Master,Single,98777,23,1000,19,711,125,115,38,2008,0,4,6,9,19
11010,1984,40,PhD,Single,16269,75,19,3,18,3,1,0,44,3,3,0,3,9
4356,1971,53,Graduation,Together,71819,70,1224,28,140,0,14,168,1574,3,3,3,5,14
3885,1983,41,PhD,Married,33569,10,16,2,18,3,0,24,63,1,1,1,2,5
1175,1983,41,Master,Married,36262,24,88,39,54,64,28,153,426,1,3,5,3,12
880,1966,58,Basic,Together,22634,47,2,23,11,8,6,46,96,1,2,1,2,6
2320,1978,46,2n Cycle,Married,47025,98,508,11,59,23,5,29,635,5,11,1,6,23
850,1968,56,Graduation,Single,70566,4,381,28,215,84,28,21,757,2,6,5,9,22
4713,1979,45,PhD,Married,31605,15,74,0,42,2,1,6,125,2,2,1,4,9
675,1973,51,Master,Divorced,52034,67,146,0,93,7,13,73,332,5,4,2,5,16
5025,1979,45,Graduation,Single,48526,32,23,17,23,43,20,9,135,1,2,1,4,8
2308,1954,70,Graduation,Married,46734,40,110,5,137,26,23,29,330,2,6,1,5,14
5995,1962,62,Graduation,Divorced,39552,54,165,3,147,4,24,41,384,7,6,2,5,20
6749,1966,58,Graduation,Single,86358,78,957,47,494,82,47,95,1722,4,5,3,6,18
1010,1977,47,Graduation,Together,46931,94,41,0,17,3,1,16,78,2,1,1,3,7
8977,1985,39,Basic,Single,16581,51,1,3,4,2,3,11,24,1,0,0,3,4
4756,1952,72,2n Cycle,Divorced,63998,42,176,29,818,0,33,112,1168,1,7,6,11,25
3412,1951,73,Master,Married,67381,67,815,8,53,11,0,70,957,4,2,2,9,17
606,1967,57,Graduation,Single,25930,87,6,1,2,2,0,4,15,1,1,0,2,4
5961,1978,46,Graduation,Married,42693,29,8,4,20,6,3,16,57,1,1,0,3,5
2975,1976,48,Graduation,Together,85606,89,717,42,864,219,30,84,1956,2,6,7,9,24
2894,1985,39,Graduation,Single,72903,74,1067,138,750,0,19,39,2013,1,7,5,8,21
7613,1974,50,2n Cycle,Together,49669,97,166,5,107,11,8,29,326,2,5,1,6,14
10542,1968,56,PhD,Married,36778,63,29,4,34,2,4,4,77,3,3,0,3,9
8015,1962,62,PhD,Divorced,85696,88,714,76,395,116,0,12,1313,1,4,6,9,20
10617,1989,35,Master,Divorced,10979,34,8,4,10,2,2,4,30,2,3,0,3,8
11166,1961,63,Graduation,Married,49678,81,229,5,56,3,2,20,315,2,6,2,4,14
849,1953,71,Master,Together,56129,65,320,48,133,39,72,48,660,4,6,2,10,22
523,1989,35,Graduation,Married,37155,51,23,0,26,7,15,3,74,1,2,0,4,7
4066,1978,46,2n Cycle,Divorced,21282,76,1,5,8,4,8,20,46,2,2,1,2,7
8414,1962,62,PhD,Single,33419,76,56,0,12,0,0,18,86,2,2,0,4,8
819,1945,79,Graduation,Widow,63285,84,508,124,249,50,38,134,1103,1,6,5,13,25
4961,1974,50,Master,Together,21255,56,29,0,25,2,2,3,61,4,2,1,4,11
749,1981,43,Graduation,Together,42162,31,46,7,59,2,4,27,145,2,3,1,3,9
5430,1956,68,Graduation,Together,54450,0,454,0,171,8,19,32,684,12,9,2,8,31
7755,1954,70,PhD,Married,57744,91,350,3,39,0,0,19,411,2,9,1,4,16
10525,1986,38,Graduation,Single,26576,40,10,0,8,0,0,9,27,1,1,0,2,4
1453,1943,81,PhD,Widow,57513,59,735,40,183,52,20,30,1060,2,9,3,13,27
8310,1964,60,Graduation,Together,68142,96,897,126,196,91,112,37,1459,3,10,4,7,24
10710,1979,45,Graduation,Married,7500,61,5,2,3,3,0,5,18,1,1,0,2,4
5031,1974,50,Graduation,Together,83145,14,777,35,731,39,137,114,1833,1,5,9,11,26
2613,1960,64,Master,Married,54197,16,162,6,37,6,13,13,237,2,1,3,6,12
213,1963,61,PhD,Single,23091,98,35,0,11,0,0,2,48,4,2,1,3,10
967,1976,48,Graduation,Married,46049,11,342,9,112,19,14,19,515,10,5,2,9,26
1077,1974,50,Graduation,Together,56715,52,258,105,239,237,172,9,1020,1,7,3,4,15
7959,1961,63,Graduation,Married,79410,19,658,80,483,123,13,13,1370,1,3,2,5,11
640,1951,73,Graduation,Married,57304,61,356,80,329,138,17,106,1026,2,7,6,10,25
4252,1965,59,Graduation,Married,44375,73,213,5,28,7,7,41,301,1,4,1,6,12
8432,1956,68,Graduation,Together,54450,0,454,0,171,8,19,32,684,12,9,2,8,31
6218,1965,59,Graduation,Married,59594,74,457,4,29,0,0,9,499,1,8,1,7,17
6905,1994,30,Graduation,Together,80685,55,241,45,604,34,26,54,1004,1,6,4,10,21
5922,1974,50,PhD,Married,40344,48,210,0,6,0,0,2,218,2,4,1,5,12
3598,1972,52,Graduation,Married,62710,53,441,35,83,7,29,11,606,4,4,2,12,22
6116,1968,56,2n Cycle,Married,48985,13,19,13,18,10,7,8,75,1,1,1,3,6
6263,1968,56,Graduation,Together,35322,34,28,9,37,12,7,13,106,3,2,0,4,9
10486,1948,76,Graduation,Married,77142,54,476,75,162,29,151,97,990,1,4,4,8,17
2410,1969,55,Graduation,Single,81657,69,364,40,425,158,60,50,1097,1,3,4,8,16
193,1996,28,Basic,Married,14421,81,0,0,2,3,3,8,16,1,1,0,2,4
3363,1974,50,2n Cycle,Married,20130,99,0,6,3,7,6,12,34,1,1,0,3,5
8278,1990,34,PhD,Married,74214,3,863,83,547,86,99,33,1711,1,8,2,5,16
10660,1957,67,Master,Married,66726,61,349,7,35,0,0,47,438,3,8,2,4,17
8686,1979,45,Basic,Together,23724,65,5,23,15,0,18,14,75,2,2,0,3,7
1604,1960,64,Master,Married,47353,93,184,2,19,8,8,4,225,3,2,2,6,13
5907,1952,72,Master,Married,33444,24,8,0,8,0,0,2,18,1,1,0,2,4
10669,1981,43,Graduation,Married,54386,8,277,21,64,62,21,25,470,2,3,2,10,17
2918,1981,43,Graduation,Divorced,28510,72,44,5,19,0,4,19,91,3,2,0,4,9
5735,1991,33,Master,Single,90638,29,1156,120,915,94,144,96,2525,1,3,4,10,18
359,1950,74,Graduation,Together,48070,33,373,14,83,6,9,19,504,3,8,2,6,19
8387,1957,67,Graduation,Married,43140,68,134,8,76,6,0,11,235,1,4,1,5,11
1829,1961,63,PhD,Divorced,54959,55,1148,0,60,0,0,24,1232,3,9,5,4,21
3839,1958,66,Basic,Single,15056,76,6,12,3,21,6,40,88,5,2,2,3,12
9392,1971,53,Graduation,Single,26954,17,4,1,11,0,0,1,17,1,1,0,2,4
2292,1985,39,Graduation,Single,22327,94,5,4,8,2,0,5,24,1,1,0,3,5
10466,1965,59,Graduation,Married,44393,86,24,2,20,2,2,10,60,2,1,0,4,7
9855,1952,72,PhD,Single,62000,25,899,0,101,0,0,20,1020,1,6,6,13,26
4088,1962,62,PhD,Together,31497,22,108,1,28,13,1,4,155,2,3,1,4,10
5231,1974,50,2n Cycle,Married,45894,15,27,2,7,0,2,13,51,1,1,0,3,5
590,1970,54,Master,Divorced,78579,35,816,66,549,216,66,99,1812,1,5,6,4,16
8732,1969,55,Master,Widow,67369,81,1298,0,70,37,14,42,1461,4,7,4,10,25
2315,1960,64,Graduation,Divorced,58401,55,10,0,11,17,29,29,96,1,1,2,2,6
3515,1952,72,Graduation,Single,62307,94,87,13,34,10,6,10,160,1,4,0,4,9
2245,1969,55,Master,Married,43641,50,57,2,51,4,2,23,139,3,2,1,4,10
6283,1968,56,Master,Divorced,63841,64,635,15,100,20,7,131,908,1,9,3,9,22
2246,1965,59,2n Cycle,Married,46891,91,43,12,23,29,15,61,183,1,2,1,4,8
6606,1969,55,Master,Married,70091,11,964,34,137,15,0,11,1161,2,5,2,10,19
5545,1972,52,PhD,Married,78075,72,572,8,259,34,35,80,988,1,3,5,5,14
7342,1961,63,2n Cycle,Widow,59184,6,341,142,113,259,151,66,1072,3,6,6,12,27
837,1977,47,Graduation,Married,54809,0,63,6,57,13,13,22,174,4,2,1,5,12
9500,1959,65,Graduation,Married,58113,66,221,104,169,102,78,84,758,3,9,2,8,22
3602,1958,66,Master,Married,51412,42,140,3,29,4,5,14,195,2,3,2,4,11
234,1979,45,Graduation,Divorced,15287,60,1,2,8,4,3,13,31,2,1,1,2,6
2995,1957,67,Master,Together,66636,64,291,10,689,84,10,0,1084,1,3,4,9,17
1118,1956,68,Master,Married,50965,87,544,13,85,8,6,29,685,3,10,4,5,22
7789,1965,59,PhD,Married,84618,96,684,100,801,21,66,0,1672,1,6,9,10,26
3068,1990,34,Graduation,Married,18351,1,1,12,9,0,14,7,43,1,2,0,3,6
8955,1957,67,PhD,Together,40451,54,35,0,4,0,0,10,49,1,1,1,2,5
945,1965,59,Graduation,Together,36317,53,87,3,25,3,2,13,133,2,3,0,4,9
5644,1957,67,Graduation,Together,42213,96,309,3,24,4,3,20,363,2,5,1,7,15
7192,1955,69,Graduation,Together,65748,58,172,73,93,95,78,34,545,2,2,4,10,18
2324,1972,52,Graduation,Together,77044,12,625,38,242,50,34,76,1065,2,7,11,11,31
697,1969,55,Graduation,Together,74918,78,972,59,913,25,19,59,2047,1,5,9,6,21
3439,1972,52,Graduation,Married,56721,64,157,6,39,6,13,75,296,5,4,1,5,15
1506,1975,49,Graduation,Single,42160,26,48,9,45,3,15,20,140,4,2,1,4,11
232,1965,59,Graduation,Single,61559,8,279,83,88,32,14,34,530,1,4,2,10,17
8876,1963,61,PhD,Together,33629,49,132,0,16,0,0,4,152,5,3,1,4,13
4500,1991,33,PhD,Together,68682,56,919,0,505,99,30,45,1598,1,4,9,10,24
9739,1963,61,Graduation,Single,34377,55,62,0,22,3,1,26,114,2,2,2,2,8
10395,1986,38,Basic,Single,8940,25,1,45,3,4,6,42,101,3,3,1,3,10
1176,1973,51,Graduation,Married,26228,50,2,6,4,3,1,9,25,1,1,0,2,4
1627,1957,67,2n Cycle,Divorced,77297,84,408,61,109,48,122,41,789,1,5,7,9,22
938,1981,43,Graduation,Married,40211,30,51,1,7,2,1,25,87,2,2,1,2,7
2740,1958,66,PhD,Widow,33438,81,62,1,16,3,2,6,90,4,2,1,4,11
257,1959,65,PhD,Married,75032,74,952,12,180,47,12,12,1215,2,5,4,9,20
4058,1955,69,PhD,Single,61284,76,618,15,106,20,7,45,811,1,11,2,8,22
7736,1986,38,Graduation,Married,22518,36,11,7,12,2,2,27,61,2,2,1,2,7
8210,1975,49,Master,Married,54730,64,318,3,17,4,7,56,405,5,4,1,8,18
833,1955,69,Master,Married,38452,62,56,0,14,0,0,2,72,3,3,0,3,9
6230,1971,53,Graduation,Divorced,44421,53,110,5,59,7,1,7,189,5,5,0,4,14
7325,1986,38,PhD,Together,38197,86,23,0,11,2,1,3,40,1,1,0,3,5
1307,1978,46,Graduation,Divorced,41986,15,27,5,8,8,3,12,63,3,3,0,4,10
1502,1983,41,Graduation,Together,28427,67,18,3,19,3,3,6,52,2,2,0,3,7
6211,1976,48,PhD,Together,37395,47,18,0,9,0,1,11,39,1,1,0,3,5
843,1971,53,Graduation,Married,64722,47,303,0,280,60,147,15,805,4,8,2,11,25
4174,1956,68,Master,Together,55249,81,97,1,19,2,0,11,130,1,2,1,4,8
9757,1972,52,Graduation,Together,84906,98,997,15,414,99,30,76,1631,1,5,6,12,24
6918,1989,35,Graduation,Married,28691,56,5,4,13,8,0,4,34,1,1,0,3,5
286,1952,72,Graduation,Single,44213,48,95,11,35,0,4,7,152,4,2,1,5,12
11086,1984,40,Basic,Single,25707,18,1,6,2,3,6,3,21,1,1,0,3,5
1921,1967,57,PhD,Married,59062,74,46,1,12,3,0,9,71,2,2,0,3,7
4138,1962,62,Graduation,Single,76624,68,411,106,147,54,115,66,899,1,5,10,7,23
7718,1947,77,Master,Together,66000,36,244,51,270,101,0,45,711,1,1,3,5,10
1291,1978,46,PhD,Together,27683,90,152,9,121,12,12,45,351,4,6,2,4,16
6862,1971,53,Graduation,Divorced,1730,65,1,1,3,1,1,1,8,15,0,0,0,15
4136,1992,32,Basic,Single,7500,63,10,17,18,8,26,40,119,4,3,2,2,11
803,1968,56,Graduation,Together,40521,82,12,0,5,0,0,4,21,1,0,1,2,4
4298,1973,51,PhD,Together,20427,63,5,0,4,0,0,1,10,1,1,0,2,4
10833,1975,49,Graduation,Married,65106,55,790,19,133,12,0,19,973,3,8,3,13,27
9606,1965,59,PhD,Married,69969,64,882,29,514,38,29,44,1536,1,4,2,6,13
8534,1952,72,Graduation,Married,67433,51,615,28,259,12,48,30,992,4,6,5,13,28
5153,1967,57,PhD,Married,77766,97,1004,59,265,115,59,27,1529,2,11,10,11,34
961,1972,52,Graduation,Married,74716,92,133,27,421,13,195,71,860,2,7,3,5,17
5011,1963,61,Graduation,Divorced,68118,51,595,23,123,10,23,154,928,2,8,9,4,23
6653,1970,54,PhD,Married,55158,72,293,0,87,4,11,23,418,4,7,2,5,18
9094,1955,69,2n Cycle,Married,62972,39,313,15,47,20,0,192,587,2,7,4,3,16
810,1975,49,Graduation,Married,74190,49,151,81,86,168,91,64,641,2,4,2,11,19
5493,1976,48,Graduation,Married,39356,21,15,0,2,0,0,6,23,1,1,0,2,4
2147,1969,55,Graduation,Together,76653,91,736,63,946,219,189,126,2279,1,4,7,11,23
5107,1973,51,PhD,Divorced,35860,37,15,0,8,4,2,20,49,2,1,1,2,6
3979,1983,41,PhD,Divorced,90687,98,982,17,672,23,34,51,1779,1,6,2,8,17
6049,1982,42,Master,Together,73450,85,1142,51,415,90,69,37,1804,1,7,8,11,27
8147,1960,64,Graduation,Married,31454,40,28,0,11,0,0,9,48,3,2,0,3,8
1857,1952,72,Graduation,Single,47139,2,46,0,12,0,2,23,83,2,2,1,2,7
3910,1975,49,Graduation,Divorced,83829,78,897,161,430,186,161,27,1862,0,4,7,6,17
5207,1963,61,PhD,Married,53378,41,489,6,152,8,6,132,793,10,9,4,6,29
11114,1970,54,Graduation,Together,19656,94,25,4,9,6,8,32,84,3,2,1,3,9
5429,1948,76,PhD,Married,45579,10,145,1,33,2,1,1,183,1,4,1,4,10
9400,1958,66,2n Cycle,Single,85485,73,630,26,611,44,18,54,1383,1,6,6,6,19
1740,1944,80,Graduation,Married,55956,22,760,38,104,50,9,38,999,2,7,3,4,16
7488,1963,61,Master,Single,64191,30,420,15,186,151,38,15,825,3,5,3,13,24
195,1972,52,Graduation,Single,38808,21,125,17,52,3,19,30,246,4,5,1,4,14
635,1966,58,Master,Married,57183,51,464,5,64,7,0,70,610,8,9,1,7,25
7527,1968,56,Master,Divorced,23748,97,6,6,29,12,15,8,76,3,2,1,3,9
10319,1971,53,Graduation,Married,66303,56,1090,12,96,16,12,60,1286,4,3,4,11,22
2296,1975,49,Master,Married,37368,4,3,2,11,2,2,10,30,1,1,0,2,4
10637,1964,60,Graduation,Married,40800,77,24,0,27,8,30,10,99,2,3,0,3,8
2931,1978,46,Graduation,Divorced,71847,95,737,21,106,55,63,210,1192,0,6,7,9,22
907,1975,49,Graduation,Married,46149,36,254,6,71,4,0,27,362,5,5,1,7,18
3698,1983,41,Graduation,Together,78687,13,817,185,687,145,55,241,2130,1,4,6,8,19
9516,1971,53,2n Cycle,Divorced,49118,90,620,54,239,99,98,119,1229,2,9,7,10,28
679,1957,67,PhD,Married,37633,49,13,4,20,0,0,1,38,2,1,0,3,6
7384,1951,73,Master,Together,39767,18,113,61,204,34,26,47,485,2,7,1,7,17
5043,1951,73,Basic,Married,26997,89,7,23,78,133,49,144,434,2,4,2,5,13
5267,1970,54,Graduation,Divorced,33986,43,16,2,18,2,1,5,44,1,1,0,3,5
339,1972,52,PhD,Married,57091,82,462,0,24,6,0,4,496,2,9,2,5,18
2516,1969,55,2n Cycle,Married,46831,84,22,2,10,6,4,34,78,2,1,2,2,7
9010,1972,52,Master,Married,83151,80,968,147,842,137,42,210,2346,1,5,7,10,23
378,1971,53,Graduation,Married,52531,68,283,112,151,51,72,125,794,2,7,2,10,21
4808,1956,68,Graduation,Married,15759,12,1,2,5,6,0,3,17,1,1,0,2,4
5068,1971,53,Graduation,Single,22804,75,14,1,7,2,1,1,26,1,2,0,2,5
7628,1973,51,2n Cycle,Married,43050,10,30,5,24,6,3,8,76,2,2,0,4,8
7128,1977,47,PhD,Single,42997,91,4,0,5,0,1,5,15,1,1,0,2,4
2811,1963,61,PhD,Single,48918,21,52,0,9,0,0,1,62,2,1,0,4,7
3551,1954,70,Master,Together,60033,28,62,1,57,19,11,48,198,2,2,1,5,10
1663,1978,46,PhD,Together,34043,97,20,2,14,3,0,10,49,1,2,0,2,5
5543,1966,58,Graduation,Together,57811,49,545,7,114,37,21,78,802,5,7,2,11,25
1577,1946,78,Graduation,Married,78569,14,558,79,622,207,175,95,1736,1,4,6,4,15
10641,1978,46,Graduation,Single,7500,5,6,5,4,13,4,25,57,4,2,1,3,10
5336,1971,53,Master,Together,157733,37,39,1,9,2,0,8,59,0,1,0,1,2
6024,1953,71,Graduation,Together,94384,62,1111,24,790,160,45,172,2302,0,5,8,5,18
1878,1985,39,2n Cycle,Married,23148,83,4,6,8,6,3,10,37,1,2,0,3,6
3099,1970,54,Graduation,Divorced,44267,48,183,5,65,3,5,49,310,5,5,2,4,16
6055,1979,45,Graduation,Married,71626,94,546,72,376,94,145,72,1305,1,5,5,8,19
5841,1966,58,Graduation,Together,60894,61,606,7,155,10,0,54,832,5,10,3,8,26
3972,1976,48,Graduation,Together,50200,70,266,6,51,8,6,64,401,6,7,1,5,19
4394,1965,59,PhD,Married,81051,43,1142,29,249,38,29,14,1501,1,5,5,12,23
5758,1982,42,Graduation,Married,65169,23,1074,0,69,0,0,46,1189,1,10,4,13,28
6658,1972,52,Graduation,Together,59868,37,771,51,154,54,10,154,1194,7,11,2,12,32
4603,1960,64,PhD,Married,65695,50,371,32,189,0,58,6,656,2,5,4,10,21
8427,1956,68,Master,Single,64857,78,556,14,717,210,0,43,1540,1,7,5,10,23
10260,1965,59,Master,Together,45143,74,202,5,74,11,5,14,311,3,6,1,5,15
7143,1955,69,2n Cycle,Together,74805,14,209,162,209,41,162,37,820,5,4,7,10,26
8789,1989,35,2n Cycle,Married,59060,77,35,40,111,36,40,12,274,3,3,1,7,14
6197,1962,62,PhD,Single,27238,39,37,0,17,0,0,3,57,3,3,0,3,9
4554,1965,59,Graduation,Together,47009,89,171,45,73,59,10,90,448,4,3,2,8,17
4937,1973,51,2n Cycle,Married,46094,62,12,2,20,3,2,5,44,1,1,0,3,5
1920,1972,52,Graduation,Married,40321,59,44,4,21,6,0,27,102,2,3,0,3,8
8749,1984,40,Graduation,Together,37235,68,20,2,9,4,6,20,61,1,1,1,2,5
1650,1960,64,Master,Married,81843,13,779,86,537,34,69,138,1643,1,5,9,12,27
10377,1958,66,Master,Together,46692,37,170,6,97,24,12,88,397,3,6,1,5,15
9206,1968,56,Graduation,Together,77382,36,491,48,231,112,105,134,1121,2,5,7,12,26
10971,1977,47,Graduation,Single,37774,28,173,8,107,7,2,176,473,4,7,2,3,16
6398,1974,50,Basic,Married,18393,2,7,10,13,16,0,4,50,2,3,0,3,8
9212,1962,62,Master,Married,72828,17,1205,0,235,19,14,205,1678,6,6,3,13,28
7937,1982,42,Graduation,Married,24711,86,10,7,25,6,3,7,58,1,3,0,3,7
839,1975,49,PhD,Married,45503,54,97,4,44,6,1,18,170,1,3,1,4,9
4246,1982,42,Master,Single,6560,2,67,11,26,4,3,262,373,0,1,0,1,2
158,1945,79,PhD,Together,71604,3,345,53,528,98,75,97,1196,1,8,3,5,17
4832,1979,45,Graduation,Married,27244,84,6,5,17,3,24,46,101,2,2,2,2,8
5621,1969,55,Graduation,Married,48752,8,73,57,100,71,15,0,316,5,6,1,5,17
1945,1962,62,Graduation,Married,71434,4,711,36,217,172,96,168,1400,3,7,4,7,21
5147,1948,76,Graduation,Single,90842,57,774,70,118,182,187,93,1424,1,4,9,13,27
2535,1978,46,Master,Married,88097,24,163,0,480,0,126,75,844,1,6,5,8,20
11039,1975,49,Graduation,Married,51948,51,82,33,54,71,30,41,311,2,5,2,4,13
9495,1982,42,Graduation,Together,71853,29,358,108,413,141,97,32,1149,1,2,8,6,17
9635,1983,41,Master,Married,35876,13,66,2,40,4,3,14,129,1,3,1,3,8
2173,1952,72,Graduation,Widow,40049,23,13,6,7,0,3,3,32,1,1,0,3,5
942,1982,42,Graduation,Single,39660,36,139,13,78,20,13,36,299,3,7,1,3,14
9386,1962,62,Graduation,Together,50127,88,274,0,21,4,6,15,320,1,5,1,6,13
5510,1977,47,Master,Married,43263,2,262,6,61,0,10,102,441,3,5,2,6,16
873,1949,75,Master,Married,62845,3,1099,0,45,0,0,34,1178,11,3,4,10,28
2253,1990,34,Graduation,Married,18929,15,32,0,8,23,4,18,85,1,1,0,4,6
5181,1982,42,Basic,Single,24367,58,2,4,2,0,11,5,24,1,1,0,2,4
979,1975,49,Graduation,Single,33249,11,6,10,21,19,14,42,112,2,2,1,3,8
10390,1959,65,2n Cycle,Married,26887,27,6,7,4,3,4,6,30,1,1,0,3,5
4698,1983,41,PhD,Married,50150,32,135,46,92,65,61,11,410,2,5,2,7,16
7793,1976,48,Graduation,Together,62061,12,641,7,84,0,30,38,800,3,10,4,7,24
1745,1962,62,PhD,Divorced,85696,88,714,76,395,116,0,12,1313,1,4,6,9,20
10590,1956,68,PhD,Together,76542,91,794,73,573,0,29,14,1483,1,4,8,10,23
5080,1993,31,Graduation,Single,70515,12,420,0,452,182,64,140,1258,1,6,6,4,17
8369,1987,37,Graduation,Together,18227,21,1,2,7,4,3,11,28,1,0,1,2,4
5232,1965,59,Graduation,Married,69139,23,86,12,75,33,15,6,227,1,4,1,5,11
2407,1982,42,Graduation,Married,69109,10,823,25,459,124,29,95,1555,1,6,6,7,20
3834,1962,62,Graduation,Single,69627,35,231,161,215,171,30,53,861,2,8,2,11,23
7912,1978,46,Graduation,Married,38136,69,8,15,27,0,20,33,103,2,3,1,2,8
7712,1946,78,PhD,Single,62159,68,182,17,259,77,70,29,634,1,6,2,10,19
1065,1963,61,Graduation,Single,80695,85,557,129,984,193,37,18,1918,1,5,8,5,19
7275,1971,53,Master,Single,33316,34,79,1,31,4,4,12,131,3,2,1,4,10
1343,1968,56,Graduation,Together,58554,55,368,24,68,38,0,88,586,6,8,2,6,22
1384,1992,32,Basic,Married,17256,10,6,4,14,8,8,22,62,2,2,1,2,7
9967,1974,50,Graduation,Divorced,53034,30,160,15,196,15,11,50,447,8,6,1,7,22
6181,1950,74,2n Cycle,Together,52203,36,488,21,238,56,108,28,939,1,8,7,11,27
10507,1977,47,2n Cycle,Divorced,59601,14,691,7,69,0,7,23,797,4,2,2,7,15
2674,1958,66,Master,Single,75154,79,543,10,205,160,143,82,1143,1,6,3,6,16
2698,1976,48,Graduation,Single,47025,52,254,7,108,20,0,26,415,3,6,3,5,17
3231,1973,51,Graduation,Married,37971,97,5,4,10,2,2,7,30,1,1,0,3,5
4096,1968,56,Master,Divorced,41335,24,112,19,21,16,14,5,187,3,4,1,4,12
10476,1958,66,Graduation,Married,67267,0,134,11,59,15,2,30,251,1,3,2,5,11
5948,1975,49,Graduation,Single,57338,96,143,6,52,11,8,17,237,2,4,1,5,12
9140,1960,64,2n Cycle,Together,50523,89,51,4,24,4,7,1,91,2,2,0,4,8
10258,1965,59,Master,Single,35791,94,27,0,5,0,0,3,35,2,1,0,3,6
5675,1960,64,PhD,Divorced,50611,98,459,0,24,6,0,4,493,6,4,5,7,22
4743,1969,55,PhD,Married,56242,72,689,8,167,11,8,88,971,5,8,4,11,28
8805,1960,64,Graduation,Single,48904,1,283,10,38,0,13,27,371,4,7,2,4,17
1542,1975,49,Graduation,Single,56243,26,347,0,35,4,3,7,396,6,4,2,8,20
6770,1985,39,Graduation,Married,21355,5,5,13,14,0,5,31,68,2,2,1,2,7
8773,1971,53,Master,Together,57420,22,280,0,18,0,0,24,322,3,5,1,6,15
10475,1970,54,Master,Together,,39,187,5,65,26,20,14,317,2,4,2,6,14
10420,1955,69,Master,Divorced,46390,56,95,14,64,2,9,38,222,1,4,2,3,10
7514,1956,68,2n Cycle,Together,54342,74,84,10,34,11,10,28,177,4,3,1,4,12
2902,1958,66,Graduation,Together,,87,19,4,12,2,2,6,45,1,1,0,3,5
4345,1964,60,2n Cycle,Single,,49,5,1,9,2,0,4,21,1,1,0,2,4
793,1973,51,Graduation,Married,20895,24,18,3,17,3,0,4,45,1,2,0,3,6
10909,1948,76,Graduation,Married,92344,9,992,24,694,51,19,119,1899,0,5,10,5,20
3769,1972,52,PhD,Together,,17,25,1,13,0,0,3,42,1,1,0,3,5
8702,1976,48,2n Cycle,Together,26907,10,9,1,7,0,3,2,22,2,1,0,3,6
4791,1980,44,Graduation,Together,44964,35,19,1,17,2,0,2,41,1,1,0,3,5
2963,1979,45,Graduation,Together,75507,56,709,93,374,104,80,80,1440,1,8,6,6,21
8216,1972,52,Master,Married,53761,7,158,0,76,13,7,71,325,6,4,4,3,17
8140,1973,51,Graduation,Together,22682,51,10,14,29,4,2,36,95,3,2,1,4,10
10146,1972,52,PhD,Together,38887,17,25,1,13,0,0,3,42,1,1,0,3,5
5289,1975,49,2n Cycle,Single,41658,30,8,4,12,15,4,29,72,2,1,1,2,6
2587,1972,52,PhD,Married,29791,21,14,0,6,0,0,0,20,2,2,0,3,7
4405,1956,68,Master,Married,63915,2,622,7,115,30,0,15,789,2,6,3,12,23
8663,1974,50,Graduation,Divorced,39996,85,11,0,3,0,0,1,15,1,1,0,2,4
2589,1972,52,Graduation,Divorced,26759,65,25,3,16,8,5,2,59,2,2,1,3,8
3421,1968,56,Master,Divorced,63841,64,635,15,100,20,7,131,908,1,9,3,9,22
10490,1969,55,PhD,Married,51039,11,100,64,79,65,0,109,417,2,6,2,4,14
4094,1961,63,Graduation,Married,60544,92,201,2,43,3,5,35,289,4,5,1,5,15
9958,1972,52,Graduation,Married,65685,54,642,14,49,0,7,57,769,1,9,2,9,21
2534,1953,71,Graduation,Married,37716,4,97,1,41,6,2,41,188,2,4,1,3,10
4188,1957,67,Graduation,Single,36864,53,204,5,39,17,0,89,354,3,5,2,4,14
6613,1970,54,Master,Married,44511,39,513,7,133,46,14,14,727,6,8,4,8,26
10827,1967,57,PhD,Married,36947,49,88,3,21,4,1,29,146,4,3,0,4,11
5491,1951,73,Master,Together,47352,70,172,12,112,8,0,15,319,4,6,1,5,16
8402,1953,71,Master,Married,67087,40,329,35,222,130,35,43,794,2,7,5,8,22
8783,1950,74,Graduation,Married,57045,40,296,13,104,11,13,17,454,3,4,2,9,18
10010,1953,71,PhD,Divorced,36957,43,100,2,16,2,1,31,152,4,3,2,2,11
618,1977,47,PhD,Married,69389,17,422,7,238,69,46,15,797,1,7,2,12,22
9121,1972,52,Graduation,Married,80134,40,1218,16,272,104,0,80,1690,2,5,3,6,16
361,1969,55,Master,Married,43142,84,5,1,7,2,1,4,20,1,1,0,2,4
4310,1944,80,Graduation,Married,80589,25,507,93,520,242,40,26,1428,1,5,10,5,21
2678,1990,34,Graduation,Single,34412,62,52,12,50,4,36,55,209,3,5,0,3,11
6376,1979,45,Graduation,Single,57537,83,191,56,139,51,8,100,545,4,4,3,8,19
524,1966,58,Basic,Together,22634,47,2,23,11,8,6,46,96,1,2,1,2,6
10341,1948,76,Graduation,Together,51315,45,68,28,39,16,30,41,222,1,2,2,5,10
5654,1972,52,Graduation,Married,36026,34,20,4,10,6,4,17,61,2,2,0,3,7
4098,1973,51,Graduation,Married,24639,3,20,3,16,0,4,1,44,3,2,0,4,9
5824,1972,52,PhD,Together,34578,1,7,0,1,0,0,0,8,1,1,0,2,4
7000,1972,52,2n Cycle,Single,65704,18,279,172,74,38,8,246,817,1,2,10,10,23
2561,1966,58,Graduation,Single,63810,45,977,12,253,16,12,101,1371,4,4,3,12,23
5229,1969,55,PhD,Together,54132,81,30,1,8,0,0,3,42,1,1,0,3,5
4086,1959,65,Graduation,Married,18690,77,6,1,7,23,4,19,60,1,1,1,2,5
2428,1970,54,Graduation,Married,28164,23,3,18,26,11,8,12,78,3,2,0,4,9
8254,1974,50,PhD,Married,34596,48,14,0,2,0,0,7,23,1,1,0,2,4
2836,1972,52,PhD,Married,43269,61,10,1,7,0,0,1,19,1,1,0,2,4
8418,1958,66,2n Cycle,Single,38741,60,7,10,17,8,6,13,61,2,2,0,3,7
1362,1972,52,Graduation,Single,31907,75,33,87,64,175,16,74,449,1,6,1,6,14
7152,1983,41,Master,Married,27100,64,12,0,13,2,0,10,37,1,1,0,3,5
10033,1973,51,2n Cycle,Divorced,31163,54,2,3,10,11,2,10,38,1,1,0,3,5
9349,1985,39,Graduation,Married,92533,84,693,21,118,110,147,42,1131,1,6,5,11,23
274,1973,51,Graduation,Single,34853,75,9,3,15,2,3,2,34,2,2,0,3,7
3388,1967,57,Graduation,Divorced,70844,16,129,26,67,3,67,2,294,5,6,1,5,17
922,1979,45,2n Cycle,Married,31086,79,16,2,11,3,0,16,48,2,1,1,2,6
8588,1961,63,Graduation,Married,60544,92,201,2,43,3,5,35,289,4,5,1,5,15
2518,1986,38,2n Cycle,Together,20491,16,5,4,5,4,2,10,30,1,0,1,2,4
574,1964,60,Graduation,Married,42523,96,14,36,11,3,26,35,125,1,1,1,4,7
3220,1983,41,Graduation,Married,39922,30,29,12,59,19,1,36,156,2,3,0,4,9
5967,1952,72,Graduation,Together,33402,60,26,2,19,10,5,8,70,3,2,1,3,9
1183,1949,75,Master,Married,36408,11,9,1,4,3,2,3,22,1,1,0,2,4
6856,1979,45,Graduation,Together,21645,75,14,0,23,4,5,19,65,3,3,0,3,9
4530,1948,76,Master,Widow,78427,36,972,19,595,180,26,138,1930,3,3,7,10,23
1553,1946,78,Graduation,Together,82657,71,966,168,672,246,105,126,2283,1,7,5,10,23
4682,1958,66,Graduation,Married,51876,88,99,27,102,28,48,6,310,1,2,2,8,13
8204,1971,53,2n Cycle,Married,78041,93,482,35,553,72,160,17,1319,1,4,4,9,18
5221,1957,67,Graduation,Married,52852,93,714,8,99,11,0,47,879,4,10,7,5,26
1232,1982,42,PhD,Together,70038,54,587,54,348,71,54,130,1244,1,4,4,8,17
1927,1973,51,2n Cycle,Together,69401,41,399,27,159,58,8,39,690,4,4,4,5,17
5788,1972,52,Graduation,Together,46053,46,56,10,92,19,7,25,209,3,3,2,4,12
6652,1965,59,Graduation,Married,77343,28,227,151,573,98,54,31,1134,1,3,4,9,17
6246,1953,71,Graduation,Single,73892,40,703,102,601,0,58,43,1507,1,3,11,8,23
5975,1967,57,PhD,Single,40304,82,37,0,17,0,0,3,57,1,2,0,3,6
6875,1965,59,PhD,Together,32727,38,167,13,180,86,13,70,529,2,7,3,5,17
4399,1969,55,Graduation,Together,68695,3,458,81,356,106,50,40,1091,1,4,4,7,16
4042,1971,53,Graduation,Divorced,43300,87,91,3,52,2,1,31,180,3,4,0,4,11
2157,1972,52,Graduation,Together,26290,49,15,8,16,11,5,22,77,4,2,0,4,10
10133,1970,54,Graduation,Single,93790,16,1302,68,731,89,114,45,2349,0,6,7,12,25
2525,1974,50,PhD,Married,38410,65,153,64,123,116,64,14,534,2,5,2,9,18
8233,1950,74,Master,Widow,64866,9,508,5,21,7,5,10,556,4,7,3,7,21
9483,1959,65,Graduation,Together,57957,24,290,59,177,77,5,29,637,7,4,6,8,25
2945,1955,69,PhD,Together,46015,25,38,0,2,0,0,6,46,1,1,0,3,5
10403,1978,46,Graduation,Together,16531,43,2,13,6,7,5,11,44,3,3,0,3,9
5074,1986,38,Master,Married,28072,10,30,0,10,2,0,5,47,1,1,0,3,5
10524,1963,61,Master,Divorced,49476,29,386,23,95,54,41,196,795,4,2,11,5,22
4690,1953,71,Graduation,Married,50725,45,443,10,75,0,10,48,586,4,8,1,8,21
7521,1952,72,Graduation,Together,83844,57,901,31,345,75,31,191,1574,1,4,4,11,20
7196,1950,74,PhD,Married,41145,20,9,0,3,0,0,1,13,1,0,0,3,4
4406,1970,54,Graduation,Together,67419,29,846,84,352,91,56,42,1471,4,9,4,8,25
9672,1970,54,2n Cycle,Married,23162,82,8,3,9,19,4,22,65,3,1,1,3,8
4864,1977,47,Graduation,Married,34380,68,72,7,58,13,1,24,175,4,4,1,3,12
4706,1966,58,Graduation,Single,34704,65,29,0,5,0,1,5,40,1,1,0,3,5
4070,1969,55,PhD,Married,94871,99,169,24,553,188,0,144,1078,1,8,5,4,18
25,1958,66,Graduation,Married,65148,9,460,35,422,33,12,153,1115,2,6,6,7,21
3697,1954,70,Graduation,Together,39898,20,69,8,26,12,7,12,134,2,3,0,4,9
217,1956,68,Master,Single,64857,78,556,14,717,210,0,43,1540,1,7,5,10,23
4220,1970,54,PhD,Married,59892,26,73,0,13,0,1,0,87,1,2,1,3,7
5286,1987,37,Master,Single,41020,68,112,1,54,7,7,36,217,1,3,2,4,10
9559,1961,63,PhD,Married,57072,79,944,0,60,0,0,30,1034,2,7,5,13,27
2849,1979,45,Graduation,Single,60474,25,265,199,303,234,9,170,1180,7,10,2,12,31
7787,1960,64,Graduation,Together,62807,83,526,28,135,10,21,99,819,3,5,3,12,23
3102,1981,43,2n Cycle,Together,19414,32,2,3,12,3,5,7,32,1,1,0,3,5
5868,1980,44,Graduation,Married,19107,49,2,4,9,10,5,16,46,2,1,0,3,6
8370,1976,48,2n Cycle,Together,75484,50,378,97,259,197,194,34,1159,2,7,3,6,18
9988,1976,48,Master,Single,70379,84,553,25,142,65,67,8,860,3,6,3,13,25
2939,1970,54,Master,Together,79419,96,751,127,687,20,15,31,1631,1,4,6,4,15
5529,1946,78,PhD,Together,64014,56,406,0,30,0,0,8,444,7,8,2,5,22
9743,1955,69,Graduation,Married,76998,85,1449,89,161,69,35,107,1910,2,11,8,8,29
5763,1972,52,Master,Together,49854,63,123,17,171,39,0,30,380,5,6,2,5,18
3478,1971,53,PhD,Married,60585,17,267,42,309,55,42,21,736,10,7,4,9,30
7494,1950,74,PhD,Divorced,42873,11,209,0,40,3,2,15,269,4,6,1,4,15
1763,1988,36,Graduation,Together,87679,62,1259,172,815,97,148,33,2524,1,7,11,10,29
7250,1978,46,Graduation,Together,57867,48,344,35,178,15,23,17,612,7,7,2,9,25
2005,1990,34,Graduation,Married,35765,86,22,3,30,0,5,15,75,2,2,0,4,8
10770,1959,65,Graduation,Married,65492,73,247,161,295,210,85,47,1045,2,4,7,13,26
6885,1977,47,Graduation,Divorced,32952,36,38,0,12,3,1,1,55,1,2,0,3,6
2072,1969,55,PhD,Together,53374,34,896,10,101,13,10,34,1064,6,4,2,9,21
9463,1959,65,Graduation,Together,71706,16,931,56,253,91,98,14,1443,4,9,5,7,25
6318,1988,36,Graduation,Married,68487,48,758,12,385,33,89,89,1366,1,9,7,13,30
4093,1975,49,Master,Together,53253,61,216,9,57,20,9,125,436,7,4,3,5,19
5751,1973,51,2n Cycle,Divorced,31163,54,2,3,10,11,2,10,38,1,1,0,3,5
3340,1977,47,Graduation,Married,42014,56,244,15,108,4,15,50,436,6,7,1,6,20
3594,1973,51,Master,Married,54108,74,539,6,91,8,6,97,747,13,8,2,9,32
3584,1955,69,PhD,Single,49667,35,1181,26,120,17,13,39,1396,2,5,10,5,22
3643,1974,50,Master,Married,63206,65,750,8,125,11,8,26,928,1,4,3,6,14
851,1972,52,Master,Married,57136,48,306,5,109,21,109,92,642,9,5,2,10,26
7706,1975,49,2n Cycle,Together,46772,88,350,104,189,197,151,57,1048,6,11,8,5,30
3967,1971,53,PhD,Married,78931,19,331,197,170,58,152,35,943,1,2,8,13,24
10128,1958,66,Graduation,Together,53977,21,620,16,165,0,24,82,907,5,5,5,12,27
486,1988,36,Graduation,Married,84219,27,434,137,400,45,137,45,1198,1,3,4,10,18
9,1975,49,Master,Single,46098,86,57,0,27,0,0,36,120,4,3,2,2,11
9451,1965,59,Graduation,Married,73538,92,811,76,428,99,137,107,1658,3,10,4,9,26
9264,1986,38,Graduation,Married,79529,1,423,42,706,73,197,197,1638,1,4,8,9,22
3865,1977,47,2n Cycle,Together,20981,14,2,12,10,6,13,30,73,1,3,1,2,7
2853,1980,44,Graduation,Single,51766,74,60,51,87,6,20,51,275,2,4,2,4,12
1490,1962,62,Graduation,Married,55759,84,675,0,85,10,7,77,854,5,10,3,8,26
6310,1978,46,Graduation,Married,33039,4,30,8,12,8,8,12,78,1,2,0,4,7
10380,1972,52,Master,Married,37787,50,40,1,40,4,3,18,106,1,3,0,3,7
3887,1970,54,Graduation,Single,27242,2,3,17,26,20,1,39,106,2,2,0,3,7
4278,1983,41,PhD,Single,87188,73,910,111,724,49,74,55,1923,1,10,2,6,19
8643,1971,53,Graduation,Together,69930,21,252,98,827,219,70,196,1662,1,4,5,12,22
1998,1976,48,Graduation,Single,37697,82,34,6,21,11,4,8,84,1,2,1,3,7
10795,1973,51,PhD,Married,37401,14,19,3,19,3,1,3,48,2,2,0,3,7
11110,1973,51,Graduation,Single,3502,56,2,1,1,0,0,1,5,0,0,0,0,0
2408,1976,48,Graduation,Married,58597,20,490,0,184,10,28,21,733,12,7,4,9,32
202,1948,76,PhD,Widow,82032,54,332,194,377,149,125,57,1234,0,4,6,7,17
7998,1958,66,Graduation,Together,28087,77,53,8,17,13,0,21,112,3,2,2,2,9
830,1987,37,PhD,Single,74004,5,784,48,560,42,176,48,1658,1,4,6,4,15
3536,1960,64,Graduation,Together,19740,65,7,11,3,10,4,20,55,2,1,1,3,7
6050,1975,49,2n Cycle,Married,57036,33,1171,43,219,19,14,47,1513,4,6,3,13,26
125,1958,66,2n Cycle,Together,53083,65,215,7,33,3,0,13,271,6,5,1,5,17
3463,1975,49,PhD,Married,69283,41,674,62,134,0,26,8,904,4,7,3,13,27
2804,1975,49,Master,Single,46098,86,57,0,27,0,0,36,120,4,3,2,2,11
3745,1988,36,2n Cycle,Married,23331,92,5,36,7,0,10,45,103,2,3,0,3,8
9771,1988,36,2n Cycle,Single,23331,97,104,20,101,24,15,5,269,6,5,1,5,17
451,1989,35,Graduation,Single,9255,91,9,0,7,2,0,4,22,1,1,1,2,5
10530,1959,65,PhD,Widow,67786,0,431,82,441,80,20,102,1156,1,3,6,6,16
1079,1971,53,PhD,Married,71969,59,1000,0,76,0,0,10,1086,3,3,4,9,19
8920,1967,57,Master,Single,59235,4,448,40,469,80,0,91,1128,3,11,2,12,28
6678,1989,35,Graduation,Together,31928,5,33,4,24,4,2,5,72,2,3,0,4,9
3852,1961,63,Master,Together,74881,48,505,72,270,36,27,54,964,4,9,2,12,27
528,1978,46,Graduation,Married,65819,99,267,38,701,149,165,63,1383,1,5,4,10,20
73,1953,71,PhD,Single,51411,81,14,0,3,0,0,1,18,1,0,0,3,4
5589,1964,60,Graduation,Divorced,51983,95,631,0,115,10,7,30,793,3,9,2,10,24
10212,1986,38,Master,Together,42386,43,65,4,16,0,4,11,100,1,3,0,3,7
6365,1987,37,2n Cycle,Married,30390,5,10,12,12,25,1,20,80,1,2,0,3,6
5636,1963,61,Graduation,Single,30983,50,51,4,50,12,1,49,167,1,4,0,3,8
591,1957,67,Graduation,Widow,66033,76,293,35,179,46,59,65,677,2,8,3,7,20
2217,1975,49,2n Cycle,Married,37284,46,11,1,2,2,1,6,23,1,0,0,3,4
2544,1951,73,Master,Divorced,57530,68,50,1,27,6,7,1,92,1,1,1,4,7
7725,1965,59,2n Cycle,Married,76800,33,173,26,255,35,71,81,641,1,4,4,7,16
8091,1956,68,Graduation,Married,63943,50,423,184,368,13,97,21,1106,1,6,4,6,17
7321,1962,62,Graduation,Together,76081,85,292,30,415,63,33,200,1033,1,4,5,4,14
5462,1974,50,Graduation,Married,67445,63,757,80,217,29,80,11,1174,5,9,6,12,32
7791,1967,57,Master,Married,37054,89,12,1,6,0,1,5,25,2,1,0,3,6
955,1962,62,Master,Together,47175,81,167,2,44,6,2,19,240,7,4,2,4,17
4037,1976,48,Graduation,Divorced,31859,77,3,1,3,8,0,5,20,1,1,0,2,4
6642,1961,63,Graduation,Divorced,27215,50,30,5,22,8,9,28,102,4,2,1,4,11
2793,1976,48,PhD,Divorced,70179,10,532,88,168,69,44,133,1034,3,7,3,13,26
5424,1983,41,Graduation,Married,39922,30,29,12,59,19,1,36,156,2,3,0,4,9
879,1976,48,Master,Married,49681,66,411,0,26,0,0,21,458,6,7,1,7,21
9530,1988,36,Graduation,Married,24645,16,5,3,4,4,1,0,17,1,1,0,2,4
4828,1954,70,Graduation,Divorced,79865,12,71,99,278,185,121,38,792,1,5,10,5,21
10699,1985,39,Graduation,Married,44322,30,46,0,40,3,0,3,92,2,3,0,3,8
1497,1952,72,Graduation,Single,47958,8,268,11,88,15,3,22,407,2,6,3,5,16
7476,1964,60,Master,Single,63972,93,928,63,254,0,12,12,1269,4,5,4,10,23
4390,1954,70,Graduation,Together,75315,14,459,15,171,142,23,31,841,2,5,4,12,23
10478,1950,74,PhD,Married,55517,53,483,0,108,0,6,36,633,5,11,1,6,23
1081,1957,67,PhD,Married,75283,26,733,9,180,12,19,66,1019,11,6,3,5,25
4261,1946,78,PhD,Single,82800,23,1006,22,115,59,68,45,1315,1,7,6,12,26
9916,1954,70,Graduation,Married,38998,92,34,1,14,0,0,5,54,3,2,0,3,8
5350,1991,33,Master,Single,90638,29,1156,120,915,94,144,96,2525,1,3,4,10,18
8135,1986,38,Master,Married,27161,41,7,4,23,7,0,11,52,1,1,0,3,5
8685,1977,47,Graduation,Married,42014,56,244,15,108,4,15,50,436,6,7,1,6,20
4967,1960,64,PhD,Together,38201,19,233,0,23,0,0,12,268,4,5,1,5,15
2130,1982,42,Graduation,Together,45203,4,35,3,67,10,8,24,147,1,3,1,3,8
9298,1947,77,PhD,Together,81574,89,1252,0,465,46,35,0,1798,1,4,5,8,18
8175,1992,32,Graduation,Married,34935,71,34,4,66,3,10,20,137,1,2,1,4,8
6257,1976,48,Master,Single,60482,81,255,43,134,37,14,24,507,1,7,2,7,17
3790,1956,68,Graduation,Together,34633,31,8,1,5,0,0,1,15,1,1,0,2,4
9952,1947,77,Master,Together,78093,53,368,32,639,13,43,10,1105,1,4,7,5,17
3503,1950,74,Graduation,Divorced,82460,78,255,47,573,52,32,15,974,1,5,3,6,15
5223,1966,58,Master,Together,45903,80,33,8,10,2,10,3,66,2,2,1,3,8
4608,1987,37,Graduation,Divorced,81361,18,163,23,424,27,65,76,778,1,3,10,13,27
1626,1973,51,PhD,Divorced,35860,37,15,0,8,4,2,20,49,2,1,1,2,6
4764,1952,72,Master,Together,40442,52,45,12,52,25,22,13,169,4,3,1,4,12
2471,1965,59,Graduation,Married,61482,39,48,58,68,16,66,43,299,1,3,2,6,12
5892,1980,44,Graduation,Married,34968,11,158,6,45,8,2,2,221,7,3,2,5,17
2612,1987,37,Graduation,Married,75794,33,754,160,625,63,32,48,1682,1,7,5,12,25
4971,1962,62,PhD,Together,31497,22,108,1,28,13,1,4,155,2,3,1,4,10
5185,1955,69,Graduation,Married,74268,83,199,66,315,97,174,41,892,1,4,3,5,13
10069,1988,36,Basic,Together,13724,43,2,7,5,2,15,27,58,1,2,0,2,5
2262,1965,59,Master,Together,45143,74,202,5,74,11,5,14,311,3,6,1,5,15
1131,1967,57,PhD,Single,52569,54,85,0,3,0,0,7,95,1,2,0,4,7
1041,1973,51,PhD,Single,48432,3,322,3,50,4,3,42,424,5,7,1,6,19
24,1960,64,Master,Together,17144,96,18,2,19,0,2,6,47,5,3,0,4,12
3409,1984,40,Graduation,Single,36108,68,141,8,129,3,11,47,339,3,7,1,4,15
7022,1971,53,Graduation,Married,76445,2,739,107,309,140,80,35,1410,1,2,5,13,21
7943,1975,49,PhD,Married,36663,40,18,0,6,3,3,5,35,1,1,1,3,6
5272,1965,59,Master,Married,53843,64,378,0,88,19,4,73,562,4,8,5,3,20
5453,1956,68,Master,Married,90226,26,1083,108,649,253,151,108,2352,1,4,7,12,24
2565,1955,69,Master,Divorced,70638,69,1016,12,215,16,12,63,1334,1,4,5,10,20
800,1960,64,Graduation,Together,44512,57,23,1,6,0,0,2,32,2,1,0,3,6
11092,1961,63,Graduation,Married,27116,78,12,1,21,2,2,3,41,2,2,0,3,7
5062,1963,61,PhD,Married,54072,71,35,0,4,0,0,0,39,1,2,0,2,5
8969,1977,47,Graduation,Married,71855,59,548,31,422,0,112,28,1141,4,5,5,11,25
4656,1990,34,2n Cycle,Single,51250,28,342,32,230,34,32,40,710,5,10,5,4,24
4480,1973,51,Master,Married,60432,61,365,3,15,4,3,11,401,5,7,2,5,19
9971,1964,60,PhD,Married,65526,22,397,19,69,12,0,9,506,1,4,4,8,17
6729,1988,36,Graduation,Single,68655,95,456,19,832,75,118,38,1538,1,4,5,11,21
1773,1978,46,2n Cycle,Married,12393,38,5,6,15,11,7,13,57,1,2,0,3,6
9242,1990,34,Graduation,Single,64509,19,836,185,575,24,25,77,1722,1,6,3,9,19
1764,1975,49,Graduation,Single,33955,92,100,2,128,23,7,10,270,4,5,1,5,15
6215,1977,47,Graduation,Married,31353,24,10,0,10,3,1,7,31,2,1,1,2,6
10099,1984,40,Graduation,Married,55434,21,238,115,215,169,69,76,882,3,5,3,13,24
5423,1983,41,Graduation,Together,28359,35,6,0,5,2,1,2,16,1,1,0,2,4
940,1987,37,Graduation,Single,57100,9,158,11,99,15,11,17,311,2,3,2,7,14
3011,1965,59,Graduation,Married,69139,23,86,12,75,33,15,6,227,1,4,1,5,11
3298,1956,68,Master,Married,52973,92,856,0,76,12,9,199,1152,7,9,6,9,31
8286,1965,59,PhD,Together,51717,55,98,1,17,0,1,5,122,1,3,0,4,8
9668,1971,53,Graduation,Married,18793,14,4,16,20,0,17,20,77,3,2,0,4,9
5120,1982,42,2n Cycle,Together,66664,78,398,96,447,220,96,32,1289,1,5,7,6,19
6097,1959,65,Graduation,Single,50664,64,313,8,104,6,4,126,561,9,8,1,6,24
7019,1963,61,Graduation,Together,54414,49,109,18,16,24,26,18,211,4,3,1,5,13
7408,1952,72,PhD,Married,54549,8,216,2,6,0,0,9,233,2,5,1,4,12
8041,1971,53,PhD,Widow,47111,35,595,71,153,120,112,41,1092,6,3,2,10,21
252,1963,61,PhD,Divorced,41003,11,123,133,142,71,44,88,601,1,6,2,8,17
9986,1982,42,Graduation,Together,19444,8,16,0,23,3,2,10,54,3,4,1,2,10
3276,1976,48,2n Cycle,Together,36301,53,11,12,35,3,5,12,78,1,3,0,3,7
3859,1947,77,PhD,Together,73059,36,410,112,420,0,82,71,1095,1,9,3,13,26
3570,1969,55,PhD,Together,42731,64,159,2,51,6,2,24,244,3,4,1,5,13
3783,1959,65,PhD,Married,52854,43,105,0,10,0,1,0,116,2,2,1,4,9
10207,1978,46,Graduation,Together,22775,40,5,1,8,0,0,1,15,1,1,0,2,4
10906,1948,76,PhD,Together,46681,52,269,15,69,15,19,38,425,2,4,6,4,16
3427,1955,69,PhD,Married,59821,11,629,0,70,0,0,35,734,6,11,2,7,26
5209,1954,70,Graduation,Divorced,50002,21,443,5,71,21,16,82,638,2,8,2,7,19
10711,1945,79,Graduation,Married,69755,23,217,77,373,111,23,93,894,1,3,6,12,22
10785,1969,55,Graduation,Married,44078,17,24,1,10,2,0,4,41,2,2,0,3,7
2814,1976,48,Master,Together,30560,6,9,1,5,4,5,7,31,1,1,0,3,5
6866,1969,55,Master,Together,35924,56,8,0,14,2,3,7,34,1,1,0,3,5
1665,1964,60,PhD,Divorced,64140,71,1459,0,61,0,15,215,1750,5,2,5,6,18
6575,1981,43,Graduation,Together,56386,51,230,48,214,13,32,75,612,8,9,1,7,25
3829,1979,45,Basic,Together,24594,94,1,3,6,10,0,9,29,1,1,0,3,5
3091,1981,43,2n Cycle,Together,75774,27,340,21,134,258,14,56,823,1,7,5,8,21
10141,1960,64,Master,Divorced,39228,1,7,1,6,0,3,3,20,1,0,0,3,4
5177,1974,50,Master,Married,58494,56,298,7,68,4,0,19,396,2,6,2,6,16
7005,1981,43,Graduation,Single,58684,71,479,35,179,28,7,85,813,1,5,3,12,21
6409,1967,57,Graduation,Divorced,57136,18,267,140,599,34,12,127,1179,1,7,5,7,20
7485,1950,74,PhD,Widow,56551,48,67,4,32,17,2,16,138,3,2,1,4,10
8079,1982,42,Graduation,Married,22448,86,3,1,8,23,2,18,55,3,2,1,3,9
8395,1961,63,Graduation,Single,82014,48,980,37,265,35,163,31,1511,1,3,6,12,22
10352,1963,61,Graduation,Widow,34213,2,50,4,28,6,3,26,117,3,3,1,2,9
4931,1977,47,Graduation,Together,157146,13,1,0,1725,2,1,1,1730,0,0,28,0,28
13,1947,77,PhD,Widow,25358,57,19,0,5,0,0,8,32,2,1,0,3,6
1834,1978,46,Master,Single,35544,77,30,5,23,4,1,4,67,1,2,0,3,6
2285,1954,70,Master,Together,36634,0,213,9,76,4,3,30,335,3,5,2,5,15
2295,1954,70,PhD,Married,62670,57,539,30,92,80,46,38,825,1,5,3,13,22
1378,1972,52,2n Cycle,Together,50334,24,284,16,160,84,16,134,694,6,7,4,6,23
2781,1981,43,Graduation,Single,72066,55,1003,34,536,134,51,34,1792,1,4,6,6,17
1165,1958,66,PhD,Single,50729,62,239,13,143,45,4,52,496,9,6,2,7,24
1404,1968,56,Graduation,Together,34916,89,51,23,82,33,0,42,231,4,5,1,3,13
6457,1976,48,Graduation,Divorced,64892,77,527,24,230,32,24,65,902,2,6,4,12,24
2639,1966,58,Graduation,Single,43602,45,19,5,12,10,3,19,68,3,3,1,2,9
8299,1989,35,PhD,Single,33996,46,40,2,15,8,0,6,71,1,1,1,3,6
6437,1985,39,2n Cycle,Single,41473,80,21,8,20,15,3,9,76,1,2,0,3,6
6912,1967,57,PhD,Married,63246,60,593,30,91,29,22,7,772,1,6,3,12,22
7327,1959,65,PhD,Married,36732,71,21,5,3,10,1,7,47,3,1,1,4,9
5299,1970,54,PhD,Married,69084,43,1181,107,199,39,30,30,1586,2,7,3,13,25
4127,1967,57,PhD,Married,77766,97,1004,59,265,115,59,27,1529,2,11,10,11,34
8143,1985,39,PhD,Single,37929,49,202,2,46,3,2,10,265,2,4,2,5,13
1964,1951,73,Graduation,Together,86610,66,446,107,768,33,196,53,1603,1,5,6,6,18
3690,1986,38,Master,Married,80141,20,1184,102,673,52,40,40,2091,1,7,4,10,22
3433,1955,69,2n Cycle,Married,72635,54,390,22,323,104,35,107,981,1,6,8,6,21
3389,1970,54,Graduation,Married,69016,61,726,53,363,123,107,161,1533,4,8,9,13,34
4712,1991,33,2n Cycle,Together,20193,18,8,8,22,24,11,9,82,1,1,1,4,7
1170,1975,49,Graduation,Married,27573,45,50,15,110,39,15,15,244,4,5,1,4,14
6347,1979,45,Basic,Single,15862,26,1,1,4,11,9,10,36,1,1,0,3,5
4065,1976,48,PhD,Married,49544,0,308,0,73,0,0,23,404,2,5,1,8,16
8230,1980,44,Graduation,Married,33228,28,22,2,31,7,4,5,71,1,2,0,3,6
1215,1978,46,Graduation,Together,70440,49,690,117,499,76,102,88,1572,1,5,10,7,23
5939,1971,53,Graduation,Together,38232,84,43,5,28,7,6,33,122,4,3,1,3,11
2156,1955,69,PhD,Married,22554,38,27,0,10,0,0,4,41,4,2,0,4,10
7788,1983,41,PhD,Married,23536,53,6,0,3,0,0,1,10,1,0,0,3,4
10323,1952,72,Graduation,Married,49413,88,205,7,41,3,2,46,304,2,4,2,5,13
7947,1969,55,Graduation,Married,42231,99,24,0,8,0,1,4,37,1,1,0,3,5
1891,1980,44,Master,Divorced,78789,12,667,50,850,21,83,83,1754,1,4,6,5,16
2570,1968,56,Graduation,Together,56534,35,691,7,61,10,0,46,815,4,10,4,7,25
9256,1971,53,Graduation,Single,58350,5,493,26,206,116,80,80,1001,4,8,3,12,27
295,1989,35,Graduation,Single,81217,77,493,70,324,146,40,84,1157,1,3,7,11,22
7397,1951,73,Graduation,Single,49090,45,494,5,82,7,0,100,688,3,7,2,9,21
6349,1987,37,Master,Divorced,61787,71,621,73,414,78,48,85,1319,1,8,4,6,19
10790,1985,39,PhD,Married,18169,40,9,0,5,0,0,7,21,1,1,0,2,4
10398,1981,43,2n Cycle,Single,24336,82,1,6,2,8,2,12,31,1,1,0,2,4
2431,1990,34,Graduation,Married,18222,70,12,4,19,12,6,14,67,1,2,0,3,6
550,1952,72,Graduation,Divorced,62335,87,243,131,217,85,6,26,708,2,3,3,13,21
1890,1971,53,2n Cycle,Together,42033,95,11,1,4,2,0,7,25,1,1,0,2,4
10742,1983,41,PhD,Married,86580,72,532,21,127,26,20,20,746,0,4,2,5,11
10356,1957,67,PhD,Divorced,41437,5,29,0,2,0,0,1,32,1,1,0,3,5
4676,1951,73,Master,Widow,73705,86,612,91,520,258,107,107,1695,2,9,6,8,25
8852,1976,48,Graduation,Married,61064,80,387,126,342,0,45,180,1080,5,8,4,11,28
3565,1955,69,Master,Married,38452,62,56,0,14,0,0,2,72,3,3,0,3,9
5294,1989,35,Graduation,Single,18358,49,6,8,19,16,4,4,57,3,3,0,4,10
1958,1973,51,PhD,Together,55012,85,582,0,65,0,0,13,660,6,8,2,9,25
7349,1973,51,Basic,Together,9722,7,6,17,16,6,16,42,103,4,3,1,3,11
8799,1984,40,PhD,Married,38175,6,70,6,69,2,3,3,153,3,3,1,4,11
1351,1956,68,Master,Together,58656,25,962,12,194,16,24,12,1220,4,7,8,13,32
1045,1965,59,Graduation,Together,52117,55,112,10,107,30,0,20,279,2,5,2,4,13
7732,1978,46,Graduation,Married,64813,81,293,0,124,179,97,52,745,1,7,2,10,20
8070,1973,51,PhD,Married,54222,98,199,12,31,3,12,7,264,1,3,3,5,12
477,1986,38,Graduation,Married,83512,31,1060,61,835,80,20,101,2157,1,4,7,10,22
7832,1959,65,Master,Married,77520,30,940,44,396,0,88,58,1526,1,8,7,7,23
2202,1978,46,Graduation,Together,41154,98,44,2,11,2,3,7,69,1,1,0,4,6
7396,1966,58,Graduation,Married,80398,92,342,51,936,207,35,26,1597,1,5,8,12,26
4055,1992,32,Basic,Single,18746,41,2,10,11,12,9,20,64,2,3,0,3,8
10340,1984,40,Graduation,Together,35196,68,75,12,141,43,39,187,497,6,6,1,5,18
10091,1956,68,Graduation,Single,60230,78,520,20,367,39,81,40,1067,2,6,3,6,17
7629,1977,47,Graduation,Married,22108,46,5,3,9,6,2,6,31,2,2,0,3,7
10640,1974,50,Graduation,Together,44392,71,87,5,71,7,12,29,211,5,4,1,4,14
3498,1976,48,PhD,Married,55424,6,462,61,184,10,53,107,877,4,7,5,9,25
6742,1979,45,Graduation,Married,17688,82,2,2,1,3,1,2,11,1,1,0,2,4
1172,1983,41,PhD,Married,92491,71,979,44,935,29,25,22,2034,1,7,5,12,25
569,1991,33,Graduation,Single,90273,32,704,129,853,120,74,111,1991,1,5,6,7,19
4686,1962,62,PhD,Widow,82571,28,861,31,558,62,95,79,1686,0,6,5,13,24
1381,1982,42,PhD,Single,38513,20,172,3,115,16,0,18,324,5,6,1,5,17
2634,1979,45,Master,Single,16653,10,5,7,31,15,4,7,69,3,2,1,3,9
10905,1955,69,Graduation,Together,42586,7,194,2,56,0,0,0,252,5,4,1,6,16
1744,1965,59,Basic,Single,23529,67,9,7,13,3,2,20,54,1,1,1,2,5
1000,1961,63,Master,Together,74881,48,505,72,270,36,27,54,964,4,9,2,12,27
3828,1951,73,Graduation,Married,71107,61,533,10,217,198,174,195,1327,2,7,6,13,28
8605,1964,60,PhD,Together,46910,36,48,0,14,0,0,6,68,2,2,0,3,7
10304,1959,65,Graduation,Married,18690,77,6,1,7,23,4,19,60,1,1,1,2,5
4351,1955,69,Graduation,Divorced,37244,90,18,2,10,0,0,25,55,1,1,1,2,5
10129,1966,58,Graduation,Together,82427,35,482,147,509,104,107,107,1456,1,3,5,12,21
2499,1958,66,2n Cycle,Single,75342,38,204,97,97,21,118,26,563,1,5,2,10,18
10092,1954,70,Graduation,Divorced,70044,46,1073,0,250,153,14,14,1504,4,7,10,5,26
7500,1967,57,Graduation,Single,79146,33,245,16,223,21,43,16,564,2,8,1,8,19
5796,1963,61,Graduation,Married,77437,70,560,21,442,29,44,29,1125,1,4,5,13,23
10556,1959,65,Graduation,Married,54984,51,173,13,131,32,3,6,358,4,6,1,6,17
1064,1971,53,PhD,Married,42403,18,22,1,11,0,5,3,42,1,1,0,3,5
48,1964,60,Graduation,Together,55761,97,136,1,12,0,3,32,184,2,4,1,3,10
7610,1983,41,Graduation,Together,37292,32,275,0,86,10,23,66,460,5,6,3,5,19
263,1945,79,PhD,Single,45576,9,56,19,29,2,14,25,145,1,3,1,3,8
10814,1947,77,Graduation,Together,70321,6,303,23,751,82,26,191,1376,1,6,5,13,25
9710,1969,55,PhD,Divorced,58086,80,708,7,62,0,0,15,792,2,11,3,7,23
9292,1952,72,Graduation,Married,81795,74,324,132,693,27,118,88,1382,1,4,11,7,23
10250,1947,77,Basic,Together,28389,49,1,5,3,7,4,8,28,1,1,0,2,4
7881,1946,78,Master,Married,66835,21,620,26,195,34,17,141,1033,1,6,4,13,24
5847,1969,55,Graduation,Divorced,69901,95,312,21,206,102,92,149,882,3,7,3,10,23
737,1949,75,PhD,Married,80360,56,1493,86,454,112,43,43,2231,2,4,4,5,15
3571,1961,63,PhD,Together,63342,48,918,21,118,13,10,21,1101,3,8,3,5,19
7807,1974,50,Graduation,Married,44989,26,98,0,106,49,10,106,369,5,5,1,5,16
3878,1980,44,2n Cycle,Single,31859,3,3,4,7,15,8,11,48,1,1,0,3,5
5092,1949,75,PhD,Widow,51569,39,380,0,47,6,0,34,467,4,7,1,7,19
2154,1971,53,Graduation,Widow,30372,33,15,0,12,7,3,7,44,3,2,0,3,8
5394,1979,45,Basic,Single,16014,42,3,9,4,7,8,7,38,4,1,1,4,10
3798,1968,56,Graduation,Married,41120,80,24,2,23,0,8,24,81,3,2,1,3,9
3524,1971,53,Master,Single,39763,9,80,1,60,4,6,16,167,2,5,1,2,10
5247,1955,69,PhD,Married,38725,52,31,0,6,2,1,5,45,2,1,0,4,7
5883,1972,52,Graduation,Married,77981,78,138,120,204,16,126,60,664,3,7,4,7,21
2118,1964,60,2n Cycle,Married,62905,68,166,75,96,119,107,59,622,3,7,2,8,20
8812,1979,45,2n Cycle,Divorced,13533,45,12,3,8,8,0,17,48,2,2,0,3,7
6616,1975,49,Graduation,Together,59481,47,178,3,85,71,66,58,461,2,3,3,8,16
2797,1977,47,Graduation,Married,72117,34,707,20,171,65,60,50,1073,1,9,7,9,26
4328,1986,38,2n Cycle,Married,21955,81,5,1,7,17,14,11,55,2,2,1,3,8
9167,1956,68,Graduation,Married,67131,72,465,71,250,93,35,62,976,3,9,2,12,26
10560,1980,44,PhD,Single,36802,23,16,1,2,0,0,1,20,1,1,0,3,5
2631,1982,42,Graduation,Together,71853,29,358,108,413,141,97,32,1149,1,2,8,6,17
8312,1961,63,Basic,Married,28249,80,1,9,7,2,14,10,43,1,2,0,3,6
5534,1975,49,Master,Married,47808,30,123,1,26,2,0,72,224,2,3,2,3,10
5093,1974,50,PhD,Divorced,25509,15,40,3,30,10,7,11,101,3,3,0,3,9
7592,1946,78,PhD,Married,51012,86,102,9,63,2,9,24,209,1,4,1,4,10
8895,1985,39,Graduation,Single,70596,68,347,44,534,17,0,26,968,1,3,5,12,21
8584,1952,72,PhD,Together,85431,54,376,53,462,168,53,53,1165,1,2,7,7,17
2694,1967,57,Graduation,Married,42664,44,21,0,3,0,0,0,24,1,1,0,3,5
8910,1955,69,Graduation,Together,42586,7,194,2,56,0,0,0,252,5,4,1,6,16
7433,1985,39,Graduation,Single,29760,87,64,4,68,7,5,17,165,4,3,1,4,12
164,1977,47,PhD,Married,28973,59,206,0,46,3,2,12,269,2,5,1,5,13
10477,1973,51,PhD,Together,39435,16,71,0,18,0,0,13,102,1,3,1,2,7
2681,1984,40,2n Cycle,Married,65370,1,71,22,112,138,89,29,461,1,2,3,13,19
5150,1979,45,Basic,Single,20194,64,0,4,7,11,10,15,47,2,2,0,3,7
5283,1976,48,PhD,Single,42473,72,93,1,21,0,4,25,144,3,2,1,4,10
9645,1968,56,Graduation,Married,64590,98,920,138,168,36,46,30,1338,1,9,4,10,24
10678,1959,65,Graduation,Together,71232,91,653,17,170,34,26,17,917,2,11,2,10,25
7261,1971,53,Graduation,Together,34600,8,199,33,60,8,3,15,318,5,5,2,5,17
9648,1967,57,Graduation,Single,46904,20,153,4,56,0,9,31,253,4,5,1,4,14
2870,1973,51,Graduation,Married,49094,6,376,0,38,11,8,69,502,5,6,3,6,20
8008,1983,41,Graduation,Together,36075,54,46,0,30,12,1,30,119,1,2,0,4,7
1513,1979,45,2n Cycle,Together,60839,72,600,21,128,223,150,128,1250,13,2,2,12,29
6173,1979,45,Graduation,Together,77298,46,425,115,292,23,35,79,969,1,6,6,11,24
1419,1950,74,Graduation,Together,34026,11,18,6,15,12,8,17,76,3,2,1,3,9
9150,1963,61,PhD,Single,48918,21,52,0,9,0,0,1,62,2,1,0,4,7
7960,1962,62,2n Cycle,Together,82122,89,734,22,350,151,25,100,1382,1,3,9,13,26
1250,1976,48,Graduation,Single,37697,82,34,6,21,11,4,8,84,1,2,1,3,7
9905,1952,72,Graduation,Together,34074,69,135,1,41,10,1,67,255,5,3,3,3,14
10691,1960,64,Master,Married,28520,55,11,0,10,0,2,20,43,1,1,1,2,5
7002,1955,69,Graduation,Single,62535,13,163,48,90,0,45,52,398,1,3,2,8,14
2952,1977,47,Master,Single,36273,80,29,3,30,3,2,9,76,2,3,0,3,8
8439,1964,60,Graduation,Together,63404,97,734,26,70,11,44,17,902,2,6,3,4,15
762,1981,43,2n Cycle,Together,75774,27,340,21,134,258,14,56,823,1,7,5,8,21
2831,1976,48,Graduation,Together,78416,99,453,38,279,188,38,183,1179,2,7,7,10,26
6977,1974,50,Graduation,Together,75702,87,1073,0,629,145,37,37,1921,1,10,5,13,29
6289,1951,73,Master,Together,59385,85,135,0,10,0,4,36,185,2,3,1,4,10
4168,1966,58,Graduation,Single,37070,30,231,7,137,4,15,39,433,9,5,1,8,23
8397,1951,73,Graduation,Married,44689,82,18,0,5,0,0,11,34,2,1,1,2,6
9284,1958,66,Graduation,Together,53977,21,620,16,165,0,24,82,907,5,5,5,12,27
6237,1966,58,PhD,Single,7144,92,81,4,33,5,2,291,416,0,23,1,1,25
3130,1964,60,Graduation,Single,18701,95,12,4,2,10,6,10,44,4,2,0,4,10
1619,1956,68,Graduation,Married,90369,2,292,51,981,224,23,17,1588,1,4,6,6,17
1990,1974,50,PhD,Single,63159,74,965,34,586,89,86,37,1797,1,3,5,8,17
5513,1966,58,Graduation,Together,37758,49,27,2,10,0,0,1,40,2,1,0,3,6
269,1963,61,PhD,Single,46757,71,777,30,163,0,51,122,1143,6,4,4,7,21
8093,1969,55,Master,Married,79734,72,572,8,232,23,62,17,914,1,4,3,6,14
10513,1992,32,Graduation,Together,63207,68,438,169,565,91,169,70,1502,1,2,3,6,12
10177,1954,70,Graduation,Divorced,72071,4,531,69,300,150,138,150,1338,3,5,4,8,20
2549,1983,41,PhD,Together,21840,80,17,0,9,0,0,1,27,1,1,0,3,5
5782,1982,42,2n Cycle,Together,58582,15,402,35,106,101,77,42,763,2,9,2,9,22
10057,1951,73,Graduation,Single,72282,70,503,27,419,90,139,153,1331,1,5,7,9,22
10307,1956,68,Graduation,Married,50387,91,369,9,87,12,14,34,525,3,6,2,8,19
8566,1961,63,PhD,Together,32583,10,5,0,3,0,0,1,9,1,1,0,2,4
2415,1962,62,Graduation,Together,62568,99,362,17,398,80,35,61,953,3,5,3,5,16
5684,1971,53,Master,Divorced,44635,25,56,0,9,0,0,3,68,2,2,0,3,7
8334,1971,53,Master,Single,33316,34,79,1,31,4,4,12,131,3,2,1,4,10
9166,1968,56,Graduation,Married,63967,57,387,84,141,73,35,162,882,3,4,4,12,23
1440,1978,46,2n Cycle,Together,52513,84,367,17,241,104,188,232,1149,2,9,5,9,25
78,1969,55,Graduation,Married,25293,51,15,0,11,0,2,9,37,1,1,1,2,5
5441,1965,59,PhD,Widow,54111,97,267,6,54,8,3,50,388,2,5,2,6,15
5302,1986,38,Graduation,Together,78394,13,298,27,697,216,24,166,1428,1,4,6,5,16
4687,1958,66,Master,Married,80739,92,674,92,736,39,0,92,1633,1,3,11,9,24
1087,1975,49,Master,Together,22669,30,16,14,36,37,22,48,173,3,4,1,2,10
6859,1987,37,Graduation,Single,29236,30,37,4,24,16,9,9,99,2,4,0,3,9
9860,1959,65,Graduation,Together,44911,11,159,0,22,2,1,31,215,3,4,1,4,12
7129,1962,62,PhD,Married,54693,72,686,17,142,23,26,35,929,8,6,4,13,31
5866,1974,50,Graduation,Together,48186,39,97,3,66,12,7,34,219,3,4,1,4,12
10521,1977,47,Graduation,Married,54809,0,63,6,57,13,13,22,174,4,2,1,5,12
7393,1978,46,Graduation,Together,41580,15,56,5,24,4,0,3,92,3,2,1,3,9
7849,1970,54,PhD,Married,80336,12,209,19,456,160,142,66,1052,1,2,9,13,25
332,1957,67,Graduation,Married,47743,56,198,2,43,0,12,20,275,3,4,1,6,14
9847,1955,69,2n Cycle,Married,62972,39,313,15,47,20,0,192,587,2,7,4,3,16
531,1954,70,PhD,Divorced,57333,55,941,14,397,76,58,176,1662,11,8,5,9,33
9576,1982,42,PhD,Together,32313,60,86,4,56,2,4,7,159,3,4,0,4,11
6906,1953,71,Master,Widow,84953,73,167,48,602,63,72,72,1024,1,3,10,4,18
7419,1968,56,Master,Divorced,27071,90,8,3,19,0,2,3,35,2,2,0,3,7
3170,1957,67,Master,Together,68148,86,389,66,408,37,57,85,1042,1,4,4,6,15
8527,1965,59,Master,Together,65735,37,239,7,119,4,15,11,395,5,6,2,6,19
7872,1975,49,PhD,Married,86836,7,179,21,273,0,21,63,557,1,6,10,6,23
9931,1963,61,PhD,Married,4023,29,5,0,1,1,1,1,9,15,0,0,0,15
10595,1990,34,Graduation,Married,30093,19,2,6,28,13,4,16,69,1,2,0,3,6
4609,1966,58,PhD,Married,57705,14,383,0,53,6,4,40,486,3,8,1,6,18
5010,1988,36,Graduation,Single,25008,72,2,8,8,6,1,9,34,2,1,0,3,6
4427,1995,29,2n Cycle,Single,83257,56,536,27,590,38,107,67,1365,1,5,10,12,28
11148,1975,49,Graduation,Together,22280,85,2,1,4,3,1,2,13,1,1,0,2,4
1168,1978,46,PhD,Married,72159,62,322,53,899,34,40,53,1401,1,4,6,10,21
9595,1961,63,Graduation,Together,64260,1,539,169,816,20,0,30,1574,1,4,5,4,14
10163,1984,40,PhD,Single,82733,28,712,50,420,65,38,38,1323,1,8,4,7,20
2886,1971,53,Master,Divorced,74290,70,1121,0,72,0,12,12,1217,4,10,8,10,32
6710,1951,73,Master,Single,58217,84,68,1,13,3,5,13,103,1,2,0,4,7
5316,1976,48,Master,Together,21024,89,36,4,18,6,2,18,84,1,2,0,4,7
9029,1972,52,PhD,Married,70116,73,707,44,603,95,58,29,1536,1,2,8,12,23
521,1985,39,Graduation,Together,54006,42,174,77,203,6,24,97,581,2,8,1,7,18
1459,1966,58,PhD,Married,69063,16,666,35,124,69,8,26,928,1,5,3,5,14
10241,1975,49,2n Cycle,Divorced,11448,16,0,0,0,6,2,6,14,1,1,0,2,4
1630,1979,45,Graduation,Single,61825,56,162,50,100,55,30,27,424,1,4,2,8,15
3254,1971,53,Graduation,Married,70886,65,407,70,239,103,88,53,960,1,5,4,4,14
9064,1982,42,Graduation,Married,69109,10,823,25,459,124,29,95,1555,1,6,6,7,20
3678,1973,51,Graduation,Widow,60208,13,488,23,71,15,0,59,656,11,8,3,7,29
4227,1968,56,Master,Together,32889,78,28,0,13,4,2,8,55,3,2,1,3,9
9467,1984,40,Graduation,Single,34738,51,3,2,10,3,0,2,20,1,1,0,3,5
8486,1971,53,Master,Together,30538,27,284,0,52,8,3,20,367,4,9,0,4,17
2186,1977,47,2n Cycle,Together,82326,30,938,142,754,159,81,183,2257,1,5,10,6,22
3286,1967,57,PhD,Divorced,26642,71,13,2,15,2,2,8,42,2,2,0,3,7
8602,1964,60,Graduation,Divorced,69932,97,412,172,153,150,105,57,1049,2,7,6,11,26
3722,1972,52,Graduation,Single,44503,83,31,1,8,0,0,8,48,2,2,0,3,7
6715,1948,76,PhD,Single,60200,3,502,19,132,0,6,26,685,6,6,2,11,25
4796,1952,72,Graduation,Divorced,49638,71,18,10,3,3,5,0,39,1,1,0,3,5
9612,1987,37,2n Cycle,Single,23830,3,1,8,6,4,8,16,43,1,1,0,3,5
3766,1959,65,Master,Widow,33051,15,100,71,243,108,94,219,835,3,9,1,8,21
1399,1958,66,Graduation,Married,72905,52,407,114,445,181,165,203,1515,1,3,7,9,20
1570,1951,73,PhD,Together,69702,8,664,9,240,50,19,57,1039,2,7,7,10,26
3426,1975,49,Graduation,Divorced,70300,89,1045,61,338,60,46,46,1596,3,5,5,13,26
3074,1984,40,PhD,Married,70643,66,1218,107,304,23,143,33,1828,1,5,8,4,18
8341,1969,55,PhD,Married,30396,22,15,0,6,0,1,12,34,2,1,1,2,6
5180,1968,56,PhD,Divorced,50616,56,128,0,16,0,1,4,149,2,4,0,4,10
6461,1969,55,Master,Single,62772,74,581,49,157,43,8,108,946,1,5,6,11,23
7679,1985,39,PhD,Single,30298,48,6,3,12,6,1,0,28,1,1,1,3,6
10702,1984,40,Graduation,Single,52413,67,185,8,133,56,56,12,450,2,7,1,7,17
7505,1957,67,PhD,Married,44155,24,22,1,9,0,0,14,46,1,1,1,2,5
5113,1971,53,PhD,Divorced,86979,67,584,100,835,65,83,35,1702,1,5,5,5,16
10858,1975,49,Graduation,Together,76532,38,355,30,177,90,138,30,820,4,9,5,7,25
2961,1982,42,Graduation,Married,42081,86,175,10,110,54,6,27,382,2,6,3,4,15
2747,1988,36,PhD,Married,67546,90,864,134,768,150,38,172,2126,1,4,10,5,20
3010,1989,35,Master,Together,88420,87,957,153,612,99,95,153,2069,1,4,7,8,20
5790,1985,39,Graduation,Married,31158,62,25,6,16,20,0,5,72,2,2,0,3,7
6892,1968,56,Graduation,Divorced,61671,23,641,7,56,0,0,28,732,8,10,4,6,28
1743,1974,50,Graduation,Single,69719,99,273,86,208,177,14,43,801,1,2,3,5,11
3578,1949,75,Graduation,Divorced,49160,29,122,21,43,25,10,15,236,2,3,1,6,12
8462,1978,46,Basic,Together,24882,52,1,4,10,29,0,36,80,1,1,1,2,5
5558,1954,70,PhD,Single,90933,90,1020,31,430,62,63,79,1685,1,4,6,4,15
4619,1945,79,PhD,Single,113734,9,6,2,3,1,262,3,277,0,27,0,0,27
8780,1950,74,PhD,Together,59292,71,378,14,68,19,14,14,507,2,3,5,8,18
10789,1964,60,PhD,Married,45759,13,42,1,18,3,0,4,68,2,2,0,3,7
10779,1983,41,Graduation,Single,22148,16,15,5,14,0,4,11,49,1,1,0,3,5
5896,1987,37,Master,Married,73395,94,272,7,80,20,7,11,397,1,4,4,6,15
2337,1971,53,Graduation,Divorced,29819,77,9,1,24,2,1,2,39,3,3,0,3,9
10951,1968,56,Graduation,Married,45688,20,279,0,18,0,0,9,306,2,3,1,8,14
544,1954,70,Graduation,Married,62820,51,398,61,265,138,61,53,976,1,3,4,6,14
17,1971,53,PhD,Married,60491,81,637,47,237,12,19,76,1028,4,6,11,7,28
10680,1986,38,Graduation,Together,33235,71,45,0,16,2,1,6,70,1,3,0,3,7
3265,1959,65,Graduation,Married,35701,36,21,1,9,7,3,5,46,1,1,0,3,5
5623,1980,44,Master,Married,31535,95,15,4,13,0,0,19,51,1,1,1,2,5
5832,1960,64,2n Cycle,Together,92556,32,493,183,352,184,23,28,1263,0,3,5,13,21
5544,1970,54,Graduation,Single,67384,32,957,40,175,158,53,107,1490,2,7,8,5,22
6417,1971,53,Master,Together,80573,85,829,138,430,60,92,15,1564,1,4,6,13,24
5831,1967,57,Graduation,Married,77870,93,1017,50,500,65,50,133,1815,3,5,5,5,18
7101,1963,61,PhD,Widow,52278,24,953,0,71,0,0,174,1198,6,10,5,10,31
10176,1968,56,Graduation,Single,57107,44,159,0,120,0,0,137,416,7,4,4,8,23
2326,1990,34,Graduation,Married,18929,15,32,0,8,23,4,18,85,1,1,0,4,6
4385,1981,43,PhD,Single,36038,82,23,0,15,0,2,7,47,2,3,0,3,8
2929,1976,48,Graduation,Single,20180,27,18,42,24,15,20,18,137,1,2,1,4,8
10686,1965,59,PhD,Together,34230,72,15,0,4,0,0,2,21,1,1,0,2,4
2546,1977,47,2n Cycle,Single,31878,7,23,4,5,10,5,23,70,1,1,0,4,6
3283,1972,52,2n Cycle,Married,70932,57,200,193,100,46,185,185,909,2,6,2,12,22
3138,1956,68,Graduation,Single,91249,84,1324,27,119,71,108,27,1676,0,7,9,6,22
4994,1943,81,Master,Single,77598,53,1193,33,281,129,66,33,1735,1,7,5,13,26
7966,1959,65,Graduation,Single,80982,48,505,137,401,104,22,22,1191,3,11,5,11,30
3112,1977,47,Master,Married,22701,2,2,4,9,0,4,5,24,1,1,0,3,5
10872,1969,55,PhD,Married,55212,65,1103,0,45,0,0,34,1182,3,4,2,11,20
2181,1970,54,Graduation,Married,70617,45,353,61,753,40,46,27,1280,1,3,3,7,14
1867,1957,67,Graduation,Single,64849,42,652,48,350,94,84,108,1336,1,9,3,6,19
1518,1965,59,Master,Married,62694,29,379,6,157,25,91,91,749,5,9,3,7,24
5734,1974,50,PhD,Married,61917,83,46,4,36,2,2,1,91,1,2,0,4,7
2878,1947,77,PhD,Married,67472,93,162,31,127,8,17,69,414,2,4,2,7,15
1458,1982,42,Master,Married,21059,40,8,3,19,3,3,8,44,3,3,0,3,9
7007,1968,56,Master,Married,29543,47,17,3,18,3,4,18,63,2,3,1,2,8
6200,1951,73,Graduation,Married,75903,50,340,108,185,130,38,100,901,2,6,6,9,23
1403,1975,49,2n Cycle,Together,34984,40,8,4,15,3,5,3,38,2,1,0,3,6
4827,1956,68,PhD,Single,54998,3,154,22,202,39,30,8,455,5,4,2,9,20
6250,1949,75,PhD,Widow,54356,62,710,15,30,20,0,0,775,3,11,2,8,24
9291,1959,65,Master,Married,34242,25,8,2,4,0,0,1,15,1,0,0,3,4
2478,1973,51,Graduation,Married,25410,48,2,2,4,13,13,4,38,1,1,0,4,6
1139,1984,40,PhD,Married,73356,56,1050,14,322,0,14,112,1512,1,5,11,5,22
5138,1950,74,Graduation,Together,28320,68,19,1,14,3,2,4,43,1,1,0,3,5
5393,1977,47,Graduation,Single,23763,64,22,0,6,6,2,6,42,1,1,0,3,5
10413,1984,40,Graduation,Married,72570,67,274,83,216,151,141,224,1089,1,4,6,12,23
5015,1976,48,Master,Married,34529,94,68,6,38,3,6,41,162,2,2,2,3,9
10868,1951,73,Graduation,Widow,70792,82,344,45,654,104,11,114,1272,2,3,4,10,19
10676,1982,42,Graduation,Married,63211,3,145,193,459,205,26,145,1173,2,3,8,7,20
2495,1974,50,Master,Married,83891,24,217,38,350,111,85,15,816,1,4,7,10,22
7842,1968,56,Graduation,Single,36065,54,18,7,34,10,2,3,74,3,3,0,3,9
9955,1954,70,Graduation,Together,39898,20,69,8,26,12,7,12,134,2,3,0,4,9
6663,1940,84,PhD,Single,51141,96,144,0,7,0,0,6,157,1,3,1,4,9
2162,1976,48,Graduation,Married,56939,19,256,34,103,90,29,49,561,2,3,3,10,18
3434,1951,73,Graduation,Single,80872,60,483,72,567,94,12,108,1336,1,4,4,10,19
7919,1976,48,PhD,Together,72335,2,1285,105,653,28,21,0,2092,1,10,4,8,23
5626,1964,60,PhD,Single,61798,13,338,4,89,11,8,13,463,1,4,2,9,16
6428,1950,74,PhD,Widow,76842,37,605,10,345,84,54,32,1130,1,1,8,7,17
8514,1976,48,Graduation,Together,29478,59,8,0,7,3,1,1,20,1,1,0,3,5
10448,1956,68,Graduation,Single,46998,55,172,41,86,45,6,27,377,5,5,3,5,18
2109,1990,34,Graduation,Single,96843,60,448,71,951,40,17,17,1544,1,6,11,10,28
7530,1950,74,PhD,Widow,56551,48,67,4,32,17,2,16,138,3,2,1,4,10
8925,1965,59,Master,Married,70053,38,512,53,98,81,179,89,1012,3,8,5,10,26
3009,1962,62,PhD,Widow,71670,8,1462,16,128,0,0,160,1766,1,5,3,6,15
6355,1978,46,Graduation,Married,44359,19,20,0,14,7,3,1,45,3,2,0,4,9
3517,1952,72,Graduation,Single,40887,32,50,4,44,10,10,43,161,3,3,1,3,10
1158,1966,58,Graduation,Divorced,48877,27,102,1,15,2,0,24,144,1,3,0,4,8
6203,1947,77,Graduation,Together,74485,58,499,149,815,173,49,49,1734,1,6,7,12,26
7165,1972,52,Graduation,Together,64474,59,381,35,172,56,86,93,823,2,8,2,10,22
3595,1963,61,Graduation,Together,77226,29,631,43,239,128,76,21,1138,2,6,8,12,28
8537,1949,75,Graduation,Widow,72643,60,526,80,553,123,94,53,1429,1,3,10,7,21
4331,1978,46,Master,Together,85738,41,913,26,376,17,26,13,1371,1,3,6,11,21
6281,1966,58,Graduation,Divorced,55686,27,673,0,199,37,47,26,982,2,6,3,5,16
4338,1983,41,Graduation,Single,39062,28,23,0,9,0,0,12,44,1,1,0,3,5
2452,1971,53,Graduation,Together,34600,8,199,33,60,8,3,15,318,5,5,2,5,17
9507,1975,49,Graduation,Married,40794,18,261,23,73,4,23,50,434,2,6,3,5,16
8360,1971,53,2n Cycle,Married,54690,76,111,16,37,7,9,18,198,3,3,1,5,12
10311,1969,55,Graduation,Married,4428,0,16,4,12,2,4,321,359,0,25,0,0,25
5117,1963,61,2n Cycle,Married,32632,32,63,151,137,153,19,53,576,2,4,4,8,18
4867,1968,56,PhD,Single,38236,2,58,0,18,2,0,10,88,4,3,0,4,11
9289,1979,45,Graduation,Married,36781,16,29,1,17,0,3,13,63,1,2,1,2,6
10913,1984,40,Master,Single,31385,56,3,2,12,0,1,9,27,1,1,0,2,4
3032,1984,40,Graduation,Married,24570,97,28,34,62,11,14,44,193,3,4,0,4,11
8524,1974,50,PhD,Divorced,25509,15,40,3,30,10,7,11,101,3,3,0,3,9
3334,1951,73,Graduation,Married,94642,35,879,143,797,106,143,143,2211,0,5,7,9,21
4470,1962,62,Master,Married,58646,3,62,1,44,6,5,22,140,1,2,1,4,8
1406,1975,49,Graduation,Single,53201,49,280,7,81,20,0,27,415,8,6,3,5,22
8619,1957,67,Graduation,Together,21994,4,9,0,6,3,1,3,22,1,0,0,3,4
10821,1978,46,Graduation,Married,57113,45,182,4,33,0,2,42,263,6,4,1,5,16
4552,1991,33,Graduation,Married,51373,37,83,2,101,64,26,117,393,1,3,5,3,12
898,1986,38,Graduation,Married,23477,39,38,15,54,3,8,29,147,3,3,0,4,10
9797,1956,68,Graduation,Married,58116,38,228,19,130,4,11,51,443,2,3,3,8,16
10949,1963,61,PhD,Divorced,72968,8,1092,37,592,145,37,55,1958,1,5,5,8,19
8212,1971,53,Master,Married,39791,89,85,15,27,13,13,21,174,2,3,1,4,10
6248,1947,77,Master,Single,91712,47,1276,24,746,94,29,48,2217,0,9,7,11,27
10164,1958,66,Graduation,Single,94472,75,1017,33,417,108,100,16,1691,1,5,5,5,16
4547,1960,64,Graduation,Together,13672,86,6,2,9,2,1,5,25,2,1,0,3,6
6815,1980,44,2n Cycle,Married,96547,4,448,21,125,52,101,62,809,0,7,6,8,21
4122,1975,49,Graduation,Married,79205,73,504,23,117,179,28,44,895,1,6,5,4,16
10841,1975,49,PhD,Together,56559,46,226,22,133,41,31,31,484,3,4,3,8,18
5370,1973,51,PhD,Married,32644,38,239,3,141,0,7,23,413,4,7,1,6,18
176,1980,44,2n Cycle,Single,67506,73,90,38,67,33,36,67,331,1,4,1,6,12
4860,1970,54,Graduation,Single,24206,66,7,2,8,3,2,3,25,1,1,0,3,5
10757,1967,57,PhD,Divorced,28420,36,4,2,5,2,0,0,13,1,1,0,2,4
4023,1970,54,Graduation,Married,22979,29,16,17,19,20,21,22,115,3,3,2,2,10
6679,1966,58,Graduation,Single,33279,29,10,3,3,0,0,0,16,1,0,0,3,4
9923,1972,52,Master,Single,46423,6,68,0,16,0,0,8,92,3,2,0,4,9
7181,1977,47,Graduation,Married,30368,97,35,0,13,2,0,2,52,2,2,0,3,7
3599,1970,54,Graduation,Married,63684,61,575,80,428,208,93,80,1464,3,8,4,8,23
405,1964,60,Graduation,Divorced,41638,68,315,0,31,4,0,91,441,4,5,5,3,17
6870,1959,65,PhD,Divorced,68805,73,182,2,49,17,13,20,283,1,3,1,7,12
832,1966,58,PhD,Together,65814,90,561,14,113,10,14,35,747,3,8,2,10,23
2002,1958,66,Graduation,Divorced,71964,81,587,51,932,180,34,86,1870,1,5,6,5,17
3657,1986,38,Graduation,Single,39146,1,94,1,33,13,12,12,165,3,4,0,4,11
500,1977,47,Graduation,Together,96876,79,908,43,735,40,194,21,1941,1,7,7,9,24
1951,1981,43,Basic,Married,34445,92,228,122,122,208,129,30,839,6,11,2,8,27
3262,1958,66,Graduation,Single,68281,31,995,112,417,42,48,41,1655,1,2,9,13,25
4102,1975,49,2n Cycle,Married,37284,46,11,1,2,2,1,6,23,1,0,0,3,4
7042,1983,41,Graduation,Married,36790,14,3,3,14,15,21,10,66,1,2,1,2,6
10598,1967,57,Graduation,Together,27943,89,12,1,16,4,1,3,37,3,2,0,3,8
255,1951,73,Graduation,Divorced,22263,31,17,0,2,0,0,2,21,2,1,0,3,6
2375,1972,52,Graduation,Together,30261,75,8,0,5,0,3,6,22,1,0,0,3,4
9829,1978,46,Graduation,Together,28587,42,22,4,17,12,10,13,78,3,2,0,4,9
6214,1982,42,Master,Married,43815,53,14,10,29,4,7,15,79,1,2,0,3,6
4954,1956,68,Graduation,Married,48195,53,106,27,68,52,7,5,265,6,4,2,5,17
7861,1952,72,Master,Married,77027,23,820,57,242,45,0,11,1175,2,8,3,6,19
4837,1965,59,PhD,Married,71322,57,753,43,226,69,10,204,1305,2,8,5,13,28
9423,1979,45,Master,Married,32765,49,13,3,17,7,3,3,46,2,2,0,4,8
4198,1965,59,Graduation,Together,29672,6,9,1,3,0,4,8,25,1,0,0,3,4
153,1953,71,Graduation,Divorced,23272,29,19,3,6,4,2,12,46,1,1,0,3,5
9323,1949,75,Master,Together,49912,5,520,8,223,32,49,42,874,4,10,5,7,26
10001,1985,39,2n Cycle,Together,7500,98,5,17,17,13,14,34,100,4,2,1,3,10
3945,1947,77,PhD,Widow,68117,80,618,44,215,0,17,36,930,2,11,8,4,25
3799,1955,69,Graduation,Married,67225,4,315,35,322,46,7,143,868,3,7,2,11,23
8625,1976,48,Graduation,Married,17649,70,15,1,23,0,5,1,45,3,3,0,3,9
3491,1975,49,Graduation,Together,55914,32,384,60,364,119,101,232,1260,4,11,6,8,29
983,1984,40,Graduation,Married,40059,82,110,29,92,28,10,145,414,1,6,2,3,12
9119,1950,74,Graduation,Together,60905,27,208,17,76,36,17,38,392,2,3,3,7,15
4786,1977,47,Graduation,Married,75330,94,555,82,257,93,61,61,1109,4,10,3,12,29
5872,1951,73,Graduation,Single,60689,23,240,90,216,63,6,24,639,4,4,4,10,22
6568,1984,40,Graduation,Married,38680,97,11,0,36,15,5,12,79,1,2,0,3,6
5628,1982,42,Graduation,Together,61416,25,848,154,323,201,61,78,1665,1,10,3,10,24
5631,1991,33,Graduation,Single,49767,92,202,47,197,55,42,149,692,1,5,4,8,18
4974,1970,54,Graduation,Single,83273,98,433,89,650,16,102,102,1392,10,4,6,9,29
8416,1981,43,Graduation,Married,29009,19,6,6,15,10,5,2,44,2,2,0,3,7
5454,1979,45,Master,Married,45057,80,37,0,7,3,0,3,50,1,2,0,3,6
4095,1971,53,Graduation,Married,37150,80,167,37,64,49,34,116,467,8,4,3,6,21
5474,1970,54,Graduation,Single,43020,79,45,7,99,4,25,43,223,3,4,1,4,12
4268,1959,65,Graduation,Married,53154,50,129,0,21,0,1,7,158,1,3,1,4,9
10701,1973,51,Graduation,Married,65308,60,713,0,264,120,80,34,1211,1,7,8,12,28
3507,1970,54,Graduation,Single,76467,44,676,161,426,210,44,58,1575,2,2,5,5,14
2079,1947,77,2n Cycle,Married,81044,0,450,26,535,73,98,26,1208,1,5,6,10,22
626,1951,73,Graduation,Married,32871,28,22,2,12,0,2,5,43,1,1,0,3,5
4426,1975,49,Graduation,Single,55801,35,367,4,51,6,4,95,527,6,7,2,6,21
2591,1959,65,Graduation,Widow,76320,49,526,35,214,69,53,35,932,2,6,3,4,15
10509,1955,69,Master,Single,36927,46,51,0,16,0,0,4,71,2,3,0,3,8
6382,1953,71,Graduation,Together,48794,97,25,0,11,3,0,15,54,1,1,0,3,5
6673,1965,59,Graduation,Single,23478,51,28,6,27,12,17,39,129,1,3,0,3,7
7441,1973,51,Graduation,Divorced,71128,80,958,159,447,20,0,31,1615,3,2,10,12,27
1071,1976,48,PhD,Divorced,70179,10,532,88,168,69,44,133,1034,3,7,3,13,26
10061,1950,74,Graduation,Married,59462,29,724,17,143,0,8,196,1088,2,9,2,12,25
7187,1969,55,Master,Together,,52,375,42,48,94,66,96,721,7,4,10,4,25
8775,1969,55,Graduation,Together,38361,74,39,0,56,20,8,14,137,3,3,1,3,10
1612,1981,43,PhD,Single,,82,23,0,15,0,2,7,47,2,3,0,3,8
2345,1982,42,PhD,Together,70038,54,587,54,348,71,54,130,1244,1,4,4,8,17
322,1978,46,Graduation,Together,42554,93,29,1,11,0,0,0,41,2,2,0,3,7
10897,1974,50,Graduation,Married,67445,63,757,80,217,29,80,11,1174,5,9,6,12,32
123,1951,73,Graduation,Widow,67046,92,544,35,133,23,151,107,993,2,4,5,4,15
6103,1948,76,Graduation,Married,42192,40,40,15,15,17,6,7,100,1,2,1,3,7
7899,1952,72,PhD,Married,77610,70,1245,33,332,21,33,16,1680,2,4,7,4,17
10500,1984,40,Graduation,Married,31761,96,19,1,20,16,14,28,98,2,3,0,4,9
1655,1979,45,Graduation,Together,34350,81,16,3,15,2,1,11,48,1,1,0,3,5
2406,1949,75,Graduation,Together,54591,63,376,4,94,12,9,24,519,3,6,2,8,19
2712,1956,68,Graduation,Married,71866,85,184,178,178,103,39,33,715,1,6,3,10,20
5517,1969,55,Graduation,Married,25293,51,15,0,11,0,2,9,37,1,1,1,2,5
10643,1987,37,PhD,Single,42000,23,124,83,267,85,59,35,653,2,5,2,11,20
2254,1983,41,Graduation,Married,69520,95,627,120,414,121,80,93,1455,1,9,6,5,21
10281,1970,54,Graduation,Divorced,64713,11,180,60,241,13,54,54,602,2,5,5,7,19
6958,1977,47,Master,Married,27889,42,14,0,4,0,0,8,26,1,1,1,2,5
954,1960,64,Basic,Widow,22123,77,3,3,24,34,7,31,102,1,2,1,3,7
5079,1971,53,Graduation,Married,,82,71,1,16,0,0,9,97,4,2,1,3,10
10339,1954,70,Master,Together,,83,161,0,22,0,0,24,207,2,4,1,4,11
4643,1973,51,Graduation,Married,27803,40,8,26,46,38,9,49,176,2,3,0,4,9
3117,1955,69,Graduation,Single,,95,264,0,21,12,6,147,450,3,6,1,5,15
6497,1960,64,Graduation,Married,51651,32,293,6,23,13,6,92,433,4,6,2,5,17
5396,1988,36,Graduation,Married,68487,48,758,12,385,33,89,89,1366,1,9,7,13,30
5250,1943,81,Master,Widow,,75,532,126,490,164,126,126,1564,1,5,5,11,22
1052,1969,55,Graduation,Married,56796,24,656,38,161,62,47,37,1001,3,8,9,7,27
2802,1992,32,2n Cycle,Married,87000,61,196,25,607,67,17,49,961,1,4,6,7,18
6343,1959,65,Graduation,Married,79823,6,835,73,380,114,73,43,1518,1,6,9,7,23
6507,1980,44,Graduation,Single,30828,16,16,11,15,2,0,12,56,2,1,1,4,8
7901,1971,53,Master,Married,34109,39,9,1,5,2,1,4,22,1,0,0,3,4
4865,1974,50,Master,Divorced,53367,2,229,7,140,10,3,11,400,7,5,1,8,21
2686,1969,55,Basic,Together,22390,49,0,1,4,15,1,5,26,1,1,0,2,4
3107,1976,48,Graduation,Together,71322,31,121,24,124,24,15,42,350,1,4,1,7,13
7734,1993,31,Graduation,Absurd,79244,58,471,102,125,212,61,245,1216,1,4,10,7,22
1146,1949,75,Master,Together,49912,5,520,8,223,32,49,42,874,4,10,5,7,26
11031,1950,74,PhD,Married,48699,90,26,1,10,2,0,1,40,1,1,0,3,5
7428,1975,49,Graduation,Together,80144,47,240,132,445,250,192,108,1367,1,3,7,8,19
975,1956,68,Graduation,Single,54252,25,178,4,26,8,4,44,264,5,4,1,5,15
1103,1976,48,Master,Married,81929,60,1486,55,278,49,0,185,2053,2,4,4,10,20
3422,1975,49,Graduation,Married,76068,67,1115,12,128,33,12,76,1376,1,2,3,4,10
1055,1976,48,Master,Married,53204,40,29,0,8,2,0,6,45,1,1,0,3,5
6544,1949,75,PhD,Together,67911,63,529,0,356,63,28,0,976,3,6,7,11,27
1241,1984,40,2n Cycle,Married,14796,1,13,3,8,7,4,16,51,2,1,0,3,6
2909,1974,50,PhD,Married,78128,89,934,24,230,16,24,36,1264,2,8,4,6,20
5802,1972,52,Basic,Married,14188,40,2,7,11,16,12,27,75,1,2,0,4,7
1407,1986,38,Basic,Married,20425,5,4,12,5,3,16,17,57,2,2,0,3,7
6183,1962,62,Master,Married,58646,3,62,1,44,6,5,22,140,1,2,1,4,8
340,1970,54,Graduation,Divorced,72967,1,158,35,179,0,0,125,497,2,7,2,8,19
5991,1949,75,Master,Married,48150,24,173,2,39,3,2,47,266,3,5,1,4,13
3104,1961,63,Graduation,Single,82332,89,830,59,968,51,79,19,2006,1,5,3,12,21
9729,1955,69,Graduation,Widow,58275,48,189,10,253,56,43,64,615,6,8,2,7,23
1008,1981,43,PhD,Together,44953,31,728,17,133,11,8,124,1021,1,7,3,13,24
11091,1953,71,Graduation,Together,34587,68,7,2,9,2,0,2,22,2,1,0,3,6
3969,1974,50,Master,Together,43018,46,35,4,17,7,6,64,133,1,2,2,2,7
1916,1954,70,Master,Married,45736,92,188,3,180,20,3,43,437,5,7,1,6,19
9907,1969,55,Master,Together,66476,80,742,28,152,25,9,57,1013,2,6,8,10,26
87,1981,43,2n Cycle,Married,27733,16,0,7,5,26,2,17,57,2,2,0,3,7
8659,1952,72,PhD,Together,69805,50,750,71,174,13,10,20,1038,2,6,8,11,27
6262,1962,62,Master,Single,72217,93,816,42,450,55,56,154,1573,1,3,10,8,22
6147,1971,53,Graduation,Divorced,25818,51,5,2,8,2,2,9,28,1,0,1,2,4
8832,1976,48,Master,Together,37509,24,37,5,56,12,8,5,123,2,3,0,4,9
10067,1976,48,2n Cycle,Together,25176,79,4,0,4,0,0,5,13,1,1,0,2,4
7532,1980,44,Graduation,Married,43586,26,99,2,11,4,0,16,132,3,3,0,4,10
4915,1956,68,2n Cycle,Married,53230,86,176,72,98,136,21,229,732,4,5,2,12,23
2115,1957,67,Graduation,Together,50116,68,54,0,10,0,0,2,66,2,1,0,4,7
2088,1972,52,Graduation,Together,84906,98,997,15,414,99,30,76,1631,1,5,6,12,24
2493,1966,58,Graduation,Married,61286,34,356,0,107,19,9,117,608,2,7,1,8,18
6292,1986,38,PhD,Married,82333,60,1311,0,359,46,89,17,1822,1,4,3,10,18
1631,1965,59,PhD,Together,65220,3,890,63,292,0,25,12,1282,4,8,4,7,23
10104,1974,50,Graduation,Together,33590,65,4,0,2,0,0,2,8,1,1,0,2,4
3006,1976,48,Graduation,Divorced,30992,83,17,0,14,7,3,2,43,1,1,0,3,5
3919,1976,48,Master,Single,72309,64,960,0,883,50,38,0,1931,1,5,6,8,20
11181,1949,75,PhD,Married,156924,85,2,1,2,1,1,1,8,0,0,0,0,0
642,1980,44,Basic,Married,16005,69,1,3,2,20,30,47,103,3,2,1,2,8
4369,1957,67,Master,Absurd,65487,48,240,67,500,199,0,163,1169,3,3,5,6,17
10127,1965,59,Graduation,Married,58692,21,301,11,61,4,7,11,395,1,8,2,4,15
271,1969,55,Graduation,Widow,40590,30,154,0,50,6,11,37,258,5,3,4,3,15
4973,1970,54,Graduation,Single,20587,39,2,3,6,4,1,9,25,1,1,1,2,5
2948,1954,70,Master,Divorced,62637,76,104,12,48,4,12,5,185,1,2,2,5,10
2715,1966,58,Master,Divorced,29435,11,70,3,37,4,2,64,180,4,3,2,2,11
10432,1974,50,Graduation,Divorced,19346,26,2,0,9,3,6,2,22,1,1,0,3,5
9216,1971,53,Graduation,Married,35788,34,23,2,11,3,1,4,44,2,2,0,3,7
7124,1968,56,Graduation,Divorced,36997,72,43,4,12,8,0,27,94,5,2,1,4,12
9727,1957,67,Graduation,Married,23539,13,4,24,11,16,1,25,81,1,2,0,4,7
5136,1973,51,Graduation,Single,65333,58,654,7,92,0,15,30,798,7,9,4,8,28
9790,1957,67,Graduation,Single,78499,12,912,72,170,47,36,97,1334,1,11,3,4,19
1818,1971,53,PhD,Together,29732,23,25,0,8,0,1,4,38,1,2,0,2,5
1100,1960,64,Master,Together,41275,33,24,4,22,0,2,9,61,4,3,1,3,11
7873,1973,51,PhD,Together,63516,30,141,11,114,15,14,5,300,4,4,1,7,16
10609,1962,62,PhD,Married,42769,15,71,0,13,3,1,0,88,2,1,1,4,8
6950,1958,66,Master,Married,49572,25,35,1,16,0,1,1,54,2,2,0,3,7
7233,1972,52,Graduation,Married,69209,4,496,32,849,229,48,128,1782,2,5,3,6,16
9481,1976,48,Graduation,Married,17148,80,9,9,11,13,10,16,68,4,3,1,3,11
7699,1969,55,Graduation,Widow,40590,30,154,0,50,6,11,37,258,5,3,4,3,15
2711,1976,48,Master,Together,30560,6,9,1,5,4,5,7,31,1,1,0,3,5
8933,1983,41,2n Cycle,Married,32146,16,26,3,23,4,7,3,66,2,2,0,4,8
8726,1964,60,2n Cycle,Divorced,41713,57,77,8,44,10,10,25,174,5,3,1,4,13
1515,1975,49,Master,Together,34176,9,11,2,7,4,2,2,28,1,1,0,3,5
5186,1955,69,PhD,Married,58482,59,576,7,115,19,7,7,731,2,7,4,9,22
10157,1965,59,Graduation,Single,59686,78,89,15,89,34,42,5,274,1,4,1,6,12
5667,1964,60,PhD,Married,60896,90,1013,30,399,60,46,153,1701,3,9,10,4,26
902,1980,44,Graduation,Together,62994,74,224,12,48,4,12,12,312,1,6,2,4,13
977,1957,67,Graduation,Together,47320,10,200,19,111,50,15,19,414,6,5,1,8,20
7313,1949,75,2n Cycle,Widow,74859,63,570,73,614,133,102,73,1565,1,6,5,11,23
7600,1992,32,Basic,Single,15253,13,1,3,3,8,1,13,29,2,1,0,3,6
9706,1974,50,PhD,Single,31560,98,62,1,20,4,0,7,94,2,2,1,3,8
2429,1954,70,Graduation,Divorced,72071,4,531,69,300,150,138,150,1338,3,5,4,8,20
3520,1990,34,Master,Single,91172,94,162,28,818,0,28,56,1092,0,4,3,7,14
10394,1984,40,Graduation,Married,90000,91,675,144,133,94,192,241,1479,1,4,8,5,18
4548,1981,43,Graduation,Single,41967,66,23,4,10,0,2,15,54,1,1,0,3,5
9362,1965,59,Graduation,Single,69263,14,492,5,32,13,5,21,568,1,9,1,7,18
3968,1970,54,2n Cycle,Divorced,65706,77,918,10,129,13,0,129,1199,1,11,3,12,27
4084,1975,49,Graduation,Together,60934,41,224,155,155,192,93,54,873,2,6,4,11,23
6721,1951,73,Graduation,Married,71965,21,572,19,286,50,38,248,1213,3,6,3,5,17
2829,1955,69,Graduation,Married,65210,25,626,0,70,0,7,28,731,2,9,3,8,22
1772,1975,49,PhD,Married,79174,2,1074,37,518,193,92,129,2043,1,5,6,7,19
1544,1967,57,Master,Divorced,81380,51,741,68,689,224,68,103,1893,1,4,2,10,17
492,1973,51,PhD,YOLO,48432,3,322,3,50,4,3,42,424,5,7,1,6,19
4377,1971,53,Graduation,Married,52914,32,254,10,44,30,10,227,575,2,7,3,3,15
4541,1955,69,Graduation,Together,38946,84,116,6,82,6,6,41,257,2,3,1,6,12
1321,1974,50,Graduation,Married,26067,49,22,2,18,0,2,12,56,3,3,0,3,9
8858,1972,52,PhD,Married,44325,69,516,0,21,0,0,5,542,4,8,2,7,21
3266,1964,60,Graduation,Married,42523,96,14,36,11,3,26,35,125,1,1,1,4,7
11187,1978,46,Basic,Single,26487,23,2,8,10,12,14,23,69,3,2,1,3,9
8207,1957,67,2n Cycle,Married,53233,18,28,0,9,3,0,0,40,1,1,0,3,5
9723,1960,64,Graduation,Married,67716,8,530,142,217,62,9,56,1016,4,7,4,13,28
2666,1972,52,Master,Married,76234,21,519,50,167,130,0,41,907,1,8,3,11,23
5721,1956,68,PhD,Married,84117,60,611,76,749,59,45,26,1566,1,7,10,6,24
10652,1957,67,Master,Together,65487,48,240,67,500,199,0,163,1169,3,3,5,6,17
1646,1972,52,Basic,Married,25224,36,4,9,12,11,2,8,46,2,1,1,3,7
4418,1983,41,Master,Single,89616,36,671,47,655,145,111,15,1644,1,7,5,12,25
2656,1971,53,Graduation,Divorced,40851,63,23,1,7,0,4,24,59,1,1,1,2,5
7990,1947,77,Graduation,Married,27469,2,9,1,2,3,2,0,17,1,0,0,3,4
8722,1957,67,2n Cycle,Married,82347,38,556,54,845,202,133,63,1853,1,7,7,10,25
7118,1957,67,Graduation,Married,73803,61,833,80,363,52,26,174,1528,2,9,5,6,22
2980,1952,72,Master,Single,8820,52,12,0,13,4,2,4,35,4,3,0,3,10
1839,1974,50,Graduation,Single,43322,25,56,7,48,10,2,18,141,1,3,0,4,8
10722,1973,51,Graduation,Together,55593,63,293,8,124,11,4,106,546,2,6,6,3,17
2632,1954,70,Graduation,Married,50501,10,297,0,38,13,0,152,500,7,5,4,4,20
9014,1975,49,Graduation,Married,37085,65,39,1,16,2,0,3,61,4,3,0,3,10
7620,1990,34,Basic,Single,16185,71,5,11,16,21,8,45,106,2,2,2,2,8
10968,1969,55,Graduation,Single,57731,0,266,21,300,65,8,44,704,4,8,8,6,26
11133,1973,51,PhD,YOLO,48432,3,322,3,50,4,3,42,424,5,7,1,6,19
2736,1978,46,Graduation,Married,73807,88,366,124,156,71,78,54,849,2,5,5,11,23
1876,1990,34,Graduation,Married,18929,15,32,0,8,23,4,18,85,1,1,0,4,6
5959,1968,56,Graduation,Single,35893,80,158,0,23,0,0,18,199,6,3,1,5,15
1092,1980,44,Graduation,Married,61014,17,269,129,495,182,43,29,1147,4,9,3,4,20
4333,1954,70,Graduation,Together,32144,76,41,0,10,0,0,3,54,4,2,1,3,10
3850,1963,61,Basic,Together,14918,52,3,3,3,15,4,15,43,1,1,0,3,5
6168,1963,61,Graduation,Divorced,45146,28,33,0,5,0,0,15,53,2,1,1,2,6
607,1955,69,2n Cycle,Divorced,41769,31,302,29,131,32,0,27,521,6,8,1,7,22
10469,1981,43,Graduation,Together,88325,42,519,71,860,93,27,53,1623,1,6,2,9,18
6983,1950,74,Master,Divorced,38054,24,23,2,17,2,1,0,45,2,2,0,3,7
3661,1995,29,2n Cycle,Single,80617,42,594,51,631,72,55,32,1435,1,4,6,8,19
9303,1976,48,Graduation,Married,5305,12,12,4,7,1,3,5,32,0,1,0,0,1
692,1954,70,Graduation,Together,36807,88,4,2,5,0,0,5,16,1,1,0,2,4
736,1983,41,Graduation,Together,28427,67,18,3,19,3,3,6,52,2,2,0,3,7
9589,1948,76,PhD,Widow,82032,54,332,194,377,149,125,57,1234,0,4,6,7,17
4838,1978,46,Graduation,Together,22775,40,5,1,8,0,0,1,15,1,1,0,2,4
9246,1985,39,Master,Together,40101,73,171,3,129,26,24,62,415,4,6,1,6,17
6261,1979,45,Graduation,Married,58025,81,270,31,88,11,48,22,470,3,3,2,10,18
7366,1982,42,Master,Single,75777,12,712,26,538,69,13,80,1438,1,3,6,11,21
10659,1979,45,2n Cycle,Together,7500,7,2,8,11,3,8,21,53,4,3,2,2,11
1448,1963,61,Master,Married,33562,33,21,12,12,0,3,3,51,3,2,0,4,9
4286,1970,54,PhD,Single,57642,24,580,6,58,8,0,27,679,3,7,6,6,22
4749,1968,56,Graduation,Together,58554,55,368,24,68,38,0,88,586,6,8,2,6,22
4478,1979,45,Graduation,Married,63777,87,457,5,106,15,17,53,653,8,11,1,6,26
4201,1962,62,Graduation,Single,57967,39,229,7,137,4,0,91,468,5,4,2,8,19
8720,1978,46,2n Cycle,Together,,53,32,2,1607,12,4,22,1679,0,0,0,1,1
10084,1972,52,Graduation,Married,24434,9,3,2,8,20,0,17,50,2,2,1,2,7
7004,1984,40,Graduation,Single,11012,82,24,3,26,7,1,23,84,3,3,1,2,9
9817,1970,54,Master,Single,44802,71,853,10,143,13,10,20,1049,2,9,4,12,27
8080,1986,38,Graduation,Single,26816,50,5,1,6,3,4,3,22,1,0,0,3,4
9432,1977,47,Graduation,Together,666666,23,9,14,18,8,1,12,62,4,3,1,3,11
8372,1974,50,Graduation,Married,34421,81,3,3,7,6,2,9,30,1,1,0,2,4
10870,1967,57,Graduation,Married,61223,46,709,43,182,42,118,247,1341,2,9,3,4,18
4001,1946,78,PhD,Together,64014,56,406,0,30,0,0,8,444,7,8,2,5,22
7270,1981,43,Graduation,Divorced,56981,91,908,48,217,32,12,24,1241,1,2,3,13,19
8235,1956,68,Master,Together,69245,8,428,30,214,80,30,61,843,2,6,5,10,23
9405,1954,70,PhD,Married,52869,40,84,3,61,2,1,21,172,3,3,1,4,11
